あるふぁべーたがんまりろん	αβγ-理論	名詞
ｱﾙﾌｧﾍﾞｰﾀｶﾞﾝﾏﾘﾛﾝ	$\alpha\beta\gamma$理論	名詞
ｱﾙﾌｧﾍﾞｰﾀｶﾞﾝﾏﾘﾛﾝ	\alpha\beta\gamma理論	名詞
あるふぁぶんさん	α分散	名詞
ｱﾙﾌｧﾌﾞﾝｻﾝ	$\alpha$分散	名詞
ｱﾙﾌｧﾌﾞﾝｻﾝ	\alpha分散	名詞
あるふぁほうかい	α崩壊	名詞
ｱﾙﾌｧﾎｳｶｲ	$\alpha$崩壊	名詞
ｱﾙﾌｧﾎｳｶｲ	\alpha崩壊	名詞
あるふぁかんわ	α緩和	名詞
ｱﾙﾌｧｶﾝﾜ	$\alpha$緩和	名詞
ｱﾙﾌｧｶﾝﾜ	\alpha緩和	名詞
あるふぁかてい	α過程	名詞
あるふぁこうぞう	α構造	名詞
ｱﾙﾌｧｺｳｿﾞｳ	$\alpha$構造	名詞
ｱﾙﾌｧｺｳｿﾞｳ	\alpha構造	名詞
あるふぁくらすたーもけい	αクラスター模型	名詞
ｱﾙﾌｧｸﾗｽﾀｰﾓｹｲ	$\alpha$クラスター模型	名詞
ｱﾙﾌｧｸﾗｽﾀｰﾓｹｲ	\alphaクラスター模型	名詞
あるふぁりゅうし	α粒子	名詞
ｱﾙﾌｧﾘｭｳｼ	$\alpha$粒子	名詞
ｱﾙﾌｧﾘｭｳｼ	\alpha粒子	名詞
あるふぁりゅうしもけい	α粒子模型	名詞
ｱﾙﾌｧﾘｭｳｼﾓｹｲ	$\alpha$粒子模型	名詞
ｱﾙﾌｧﾘｭｳｼﾓｹｲ	\alpha粒子模型	名詞
あるふぁせん	α線	名詞
ｱﾙﾌｧｾﾝ	$\alpha$線	名詞
ｱﾙﾌｧｾﾝ	\alpha線	名詞
あるふぁせんすぺくとろめーたー	α線スペクトロメーター	名詞
ｱﾙﾌｧｾﾝｽﾍﾟｸﾄﾛﾒｰﾀｰ	$\alpha$線スペクトロメーター	名詞
ｱﾙﾌｧｾﾝｽﾍﾟｸﾄﾛﾒｰﾀｰ	\alpha線スペクトロメーター	名詞
あBきゅうぞうふく	AB級増幅	名詞
あC	AC	名詞
あCDちぇんかんき	AC-DC変換器	名詞
あでぇんかんき	A-D変換器	名詞
あGしんくろとろん	AGシンクロトロン	名詞
あGしゅうそく	AG集束	名詞
あ15こうぞう	A15構造	名詞
あきゅうぞうふく	A級増幅	名詞
あM	AM	名詞
あんDかいろ	AND回路	名詞
あPWほう	APW法	名詞
あVFさいくろとろん	AVFサイクロトロン	名詞
あーばっくそく	アーバック則	名詞
あばらんしだいおーど	アバランシダイオード	名詞
あばらんしかうんたー	アバランシカウンター	名詞
あっべすう	アッベ数	名詞
あべれすほう	アベレス法	名詞
あーべるぐん	アーベル群	名詞
あーべるへんかん	アーベル変換	名詞
あぼがどろ	アボガドロ	人名
ｱﾎﾞｶﾞﾄﾞﾛ	Avogadro	人名
あぼがどろのほうそく	アボガドロの法則	名詞
あぼがどろていすう	アボガドロ定数	名詞
あぶらいりこんでんさー	油入りコンデンサー	名詞
あぶらかいてんぽんぷ	油回転ポンプ	名詞
あぶらかくさんぽんぷ	油拡散ポンプ	名詞
あぶらみのしき	アブラミの式	名詞
あぶりこそふ	アブリコソフ	人名
じそくせんこうぞう	磁束線構造	名詞
あだまーる	アダマール	人名
へんかんぶんこうほう	変換分光法	名詞
あでやーのかいせきほう	アデヤーの解析法	名詞
あどみたんす	アドミタンス	名詞
あどみたんすぎょうれつ	アドミタンス行列	名詞
あどらーのいじょう	アドラーの異常	名詞
あーがんどず	アーガンド図	名詞
あはらのふぼーむこうか	アハラノフ・ボーム効果	名詞
あいこなーる	アイコナール	名詞
あいこなーるきんじ	アイコナール近似	名詞
あいんしゅたいん	アインシュタイン	人名
ｱｲﾝｼｭﾀｲﾝ	Einstein	人名
あいんしゅたいんどはーすこうか	アインシュタイン・ドハース効果	名詞
あいんしゅたいんひねつ	アインシュタイン比熱	名詞
あいんしゅたいんほうていしき	アインシュタイン方程式	名詞
あいんしゅたいんのもけい	アインシュタイン模型	名詞
あいんしゅたいんのひねつしき	アインシュタインの比熱式	名詞
あいんしゅたいんのかんけいしき	アインシュタインの関係式	名詞
あいんしゅたいんのねんどしき	アインシュタインの粘度式	名詞
あいんしゅたいんのうちゅう	アインシュタインの宇宙	名詞
じゅうりょくていすう	重力定数	名詞
ﾎﾟﾄﾞﾙｽｷｰ	ポドルスキー	人名
ろーぜん	ローゼン	人名
あいりすがたかそくかん	アイリス型加速管	名詞
あいそばりっく	アイソバリック	名詞
あいそべくとる	アイソベクトル	名詞
あいそまー	アイソマー	名詞
あいそれーたー	アイソレーター	名詞
あいそすからー	アイソスカラー	名詞
あいそすぴん	アイソスピン	名詞
あいそとぴっくすぴん	アイソトピックスピン	名詞
あいそたくちっくこうぶんし	アイソタクチック高分子	名詞
あいすもけい	アイス模型	名詞
あきーざーそんしつ	アキーザー損失	名詞
あこーすてぃっくえみっしょん	アコースティックエミッション	名詞
あこーすてぃっくちぇんばー	アコースティックチェンバー	名詞
あーく	アーク	名詞
あーくほうでん	アーク放電	名詞
あーくこうげん	アーク光源	名詞
あくりーしょんでぃすく	アクリーションディスク	名詞
あーくろ	アーク炉	名詞
あくろまーと	アクロマート	名詞
あーくせん	アーク線	名詞
あくせぷたー	アクセプター	名詞
あくせぷたんす	アクセプタンス	名詞
あくせぷたーじゅんい	アクセプター準位	名詞
あーくすぺくとる	アークスペクトル	名詞
あくちないど	アクチナイド	名詞
あくちにうむけいれつ	アクチニウム系列	名詞
あくちのいどげんそ	アクチノイド元素	名詞
あーくとう	アーク灯	名詞
あーくとくせい	アーク特性	名詞
あまが	アマガ	名詞
あまがあつりょくけい	アマガ圧力計	名詞
あめーばうんどう	アメーバ運動	名詞
あみめこうぞう	網目構造	名詞
あみじょうこうぶんし	網状高分子	名詞
あもんとんのほうそく	アモントンの法則	名詞
あもるふぁす	アモルファス	名詞
あもるふぁすはんどうたい	アモルファス半導体	名詞
あもるふぁすきんぞく	アモルファス金属	名詞
あもるふぁすきょうじせいたい	アモルファス強磁性体	名詞
あならいざー	アナライザー	名詞
あなろぐかいろ	アナログ回路	名詞
あなろぐけいさんき	アナログ計算機	名詞
あなろぐしんごう	アナログ信号	名詞
あなろぐじょうたい	アナログ状態	名詞
あなすてぃぐまーと	アナスティグマート	名詞
あんびる	アンビル	名詞
あんだーそん	アンダーソン	人名
あんだーそんはみるとにあん	アンダーソンハミルトニアン	名詞
あんだーそんきょくざい	アンダーソン局在	名詞
あんだーそんもけい	アンダーソン模型	名詞
あんだーそんのちょっこうていり	アンダーソンの直交定理	名詞
あんだーそんてんい	アンダーソン転移	名詞
あんだーそんゆーばるのりろん	アンダーソン・ユーバルの理論	名詞
あんだーしゅーと	アンダーシュート	名詞
あんでんりゅう	暗電流	名詞
あねろいどきあつけい	アネロイド気圧計	名詞
あねるぎー	アネルギー	名詞
あにーる	アニール	名詞
あんこくせいうん	暗黒星雲	名詞
あんもにあめーざー	アンモニアメーザー	名詞
あんないちゅうしんきんじ	案内中心近似	名詞
あのーど	アノード	名詞
あんぺあまいめーとる	アンペア毎メートル	名詞
あんぺーる	アンペール	人名
ｱﾝﾍﾟｰﾙ	Ampere	人名
あんぺーるのかいろていり	アンペールの回路定理	名詞
あんぷりだいん	アンプリダイン	名詞
あんしやぞう	暗視野像	名詞
あんそうおん	暗騒音	名詞
あんしょし	暗所視	名詞
あんていへいこう	安定平衡	名詞
あんていいそう	安定位相	名詞
あんていけいすう	安定係数	名詞
あんていそう	安定相	名詞
あんていていこうかん	安定抵抗管	名詞
あんてんほう	鞍点法	名詞
あんてんほう	あん点法	名詞
あんちこいんしでんす	アンチコインシデンス	名詞
あんとーのふのきそく	アントーノフの規則	名詞
あんじゅれーたー	アンジュレーター	名詞
あぽでぃぜーしょん	アポディゼーション	名詞
あっぷんじしん	圧粉磁心	名詞
あぷらなーと	アプラナート	名詞
あらびき	粗引き	名詞
そはいき	粗排気	名詞
あらいそくばく	粗い束縛	名詞
あらさけいすう	粗さ係数	名詞
あれいきでんし	亜励起電子	名詞
あれいもけい	亜鈴模型	名詞
あれにうすのしき	アレニウスの式	名詞
あーれんすぷりずむ	アーレンスプリズム	名詞
あれすたー	アレスター	名詞
あろすてりっくこうか	アロステリック効果	名詞
あろすてりっくちょうせつ	アロステリック調節	名詞
あるべど	アルベド	名詞
あるべーんは	アルベーン波	名詞
あるべーんそくど	アルベーン速度	名詞
あるべーんすう	アルベーン数	名詞
あるだーてんい	アルダー転移	名詞
あるふぁとろんげーじ	アルファトロンゲージ	名詞
あるごんほうでん	アルゴン放電	名詞
あるごんふあんていせい	アルゴン不安定性	名詞
あるごるがたへんこうせい	アルゴル型変光星	名詞
あるかりどるいきんぞく	アルカリ土類金属	名詞
ありゅうかい	亜粒界	名詞
あさいふじゅんぶつじゅんい	浅い不純物準位	名詞
あさいじゅんい	浅い準位	名詞
あっしゅくは	圧縮波	名詞
そみつは	疎密波	名詞
あっしゅくいんし	圧縮因子	名詞
あっしゅくせいりゅうたい	圧縮性流体	名詞
あすまんつうふうかんしつけい	アスマン通風乾湿計	名詞
あすぺくとひ	アスペクト比	名詞
あすぴれーたー	アスピレーター	名詞
あすとんあんぶ	アストン暗部	名詞
あすとろん	アストロン	名詞
あたくちっくこうぶんし	アタクチック高分子	名詞
あたまなしばんど	頭なしバンド	名詞
あとひきうず	あとひき渦	名詞
あとみすてぃーく	アトミスティーク	名詞
あとしゅうしゅく	後収縮	名詞
あとうっどのきかい	アトウッドの器械	名詞
あつでんはんどうたい	圧電半導体	名詞
あつでんがたはんどうたい	圧電型半導体	名詞
あつでんへんかんき	圧電変換器	名詞
あつでんそし	圧電素子	名詞
あつでんへんかんそし	圧電変換素子	名詞
あつでんけっしょう	圧電結晶	名詞
あつでんき	圧電気	名詞
あつでんきしんどう	圧電気振動	名詞
あつでんこうか	圧電効果	名詞
あつでんりつ	圧電率	名詞
あつでんせいけっしょう	圧電性結晶	名詞
あつでんせらみっくそし	圧電セラミック素子	名詞
あつでんしんどうし	圧電振動子	名詞
あつえんじきいほうせい	圧延磁気異方性	名詞
あつれんず	厚レンズ	名詞
あつにくれんず	厚肉レンズ	名詞
あつりょくこうばい	圧力勾配	名詞
あつりょくちゅうしん	圧力中心	名詞
あつりょくていこう	圧力抵抗	名詞
あわばこ	泡箱	名詞
あわみつど	泡密度	名詞
あわもけい	泡模型	名詞
あずべるかーなーこうか	アズベル・カーナー効果	名詞
べーたあんていきょくせん	β安定曲線	名詞
ﾍﾞｰﾀｱﾝﾃｲｷｮｸｾﾝ	$\beta$安定曲線	名詞
ﾍﾞｰﾀｱﾝﾃｲｷｮｸｾﾝ	\beta安定曲線	名詞
べーたほうかい	β崩壊	名詞
ﾍﾞｰﾀﾎｳｶｲ	$\beta$崩壊	名詞
ﾍﾞｰﾀﾎｳｶｲ	\beta崩壊	名詞
べーたかんわ	β緩和	名詞
ﾍﾞｰﾀｶﾝﾜ	$\beta$緩和	名詞
ﾍﾞｰﾀｶﾝﾜ	\beta緩和	名詞
べーたこうぞう	β構造	名詞
ﾍﾞｰﾀｺｳｿﾞｳ	$\beta$構造	名詞
ﾍﾞｰﾀｺｳｿﾞｳ	\beta構造	名詞
べーたせん	β線	名詞
ﾍﾞｰﾀｾﾝ	$\beta$線	名詞
ﾍﾞｰﾀｾﾝ	\beta線	名詞
べーたせんあつみけい	β線厚み計	名詞
ﾍﾞｰﾀｾﾝｱﾂﾐｹｲ	$\beta$線厚み計	名詞
ﾍﾞｰﾀｾﾝｱﾂﾐｹｲ	\beta線厚み計	名詞
べーたせんぶんこうがく	β線分光学	名詞
ﾍﾞｰﾀｾﾝﾌﾞﾝｺｳｶﾞｸ	$\beta$線分光学	名詞
ﾍﾞｰﾀｾﾝﾌﾞﾝｺｳｶﾞｸ	\beta線分光学	名詞
べーたせんげん	β線源	名詞
ﾍﾞｰﾀｾﾝｹﾞﾝ	$\beta$線源	名詞
ﾍﾞｰﾀｾﾝｹﾞﾝ	\beta線源	名詞
べーたせんすぺくとろめーたー	β線スペクトロメーター	名詞
ﾍﾞｰﾀｾﾝｽﾍﾟｸﾄﾛﾒｰﾀｰ	$\beta$線スペクトロメーター	名詞
ﾍﾞｰﾀｾﾝｽﾍﾟｸﾄﾛﾒｰﾀｰ	\beta線スペクトロメーター	名詞
べーたせんしょうしゃ	β線照射	名詞
ﾍﾞｰﾀｾﾝｼｮｳｼｬ	$\beta$線照射	名詞
ﾍﾞｰﾀｾﾝｼｮｳｼｬ	\beta線照射	名詞
べーたしんどう	β振動	名詞
ﾍﾞｰﾀｼﾝﾄﾞｳ	$\beta$振動	名詞
ﾍﾞｰﾀｼﾝﾄﾞｳ	\beta振動	名詞
べーたち	β値	名詞
ﾍﾞｰﾀﾁ	$\beta$値	名詞
ﾍﾞｰﾀﾁ	\beta値	名詞
ばげーじ	BAゲージ	名詞
BCSりろん	BCS理論	名詞
べてょう	BET法	名詞
BF3けいすうかん	BF3計数管	名詞
BGKのかい	BGKの解	名詞
BHきょくせん	B-H曲線	名詞
Bっかん	BK管	名詞
Bくぉーく	bクォーク	名詞
Bきゅうぞうふく	B級増幅	名詞
BRしぇんかん	BRS変換	名詞
Bつ	BTU	名詞
BWじょうたい	BW状態	名詞
ばーばさんらん	バーバ散乱	名詞
ばびね	バビネ	人名
ﾊﾞﾋﾞﾈ	Babinet	人名
ばびねのげんり	バビネの原理	名詞
ばびねのほしょうばん	バビネの補償板	名詞
ばびねそれいゆ	バビネ・ソレイユ	人名
ほしょうばん	補償板	名詞
ばぶるどめいん	バブルドメイン	名詞
ばぶるじく	バブル磁区	名詞
ﾊﾞｯﾌｧｷｵｸｿｳﾁ	バッファ記憶装置	名詞
ﾊﾞｯﾌｧｿﾞｳﾌｸｷ	バッファ増幅器	名詞
ﾊﾞｰｶﾞｰｽﾍﾟｸﾄﾙ	バーガースペクトル	名詞
ﾊﾞｰｶﾞｰｽﾓｹｲ	バーガース模型	名詞
ﾊﾞｯｸﾞﾓｹｲ	バッグ模型	名詞
ﾊﾞｰｸﾞﾏﾝﾉﾋｮｳｶｼｷ	バーグマンの評価式	名詞
ﾊﾞｯﾌﾙ	バッフル	名詞
ﾊﾞｲｱｽ	バイアス	名詞
ﾊﾞｲﾌﾞﾛﾆｯｸｼﾞｮｳﾀｲ	バイブロニック状態	名詞
ﾊﾞｲﾒﾀﾙ	バイメタル	名詞
ﾊﾞｲｵﾝ	バイオン	名詞
ﾊﾞｲｵﾝ	倍音	名詞
ﾊﾞｲｵﾆｸｽ	バイオニクス	名詞
ﾊﾞｲﾎﾟｰﾗｰｼｭｳｾｷｶｲﾛ	バイポーラｰ集積回路	名詞
ﾊﾞｲﾘﾂｷ	倍率器	名詞
ﾊﾞｲｾｲﾄﾞ	倍精度	名詞
ﾊﾞｰｶｽｺｳｶ	バーカス効果	名詞
ﾊﾞｯｸﾍﾞﾝﾃﾞｨﾝｸﾞ	バックベンディング	名詞
ﾊﾞｯｸﾗｯｼ	バックラッシ	名詞
ﾊﾞｰｺﾌﾉﾃｲﾘ	バーコフの定理	名詞
ﾊﾞｸｺﾞｳ	爆ごう	名詞
ﾊﾞｸｽﾀｰﾓｹｲ	バクスター模型	名詞
ﾊﾞｸｼｭｸ	爆縮	名詞
ﾊﾞｸﾃﾘｵﾌｧｰｼﾞ	バクテリオファージ	名詞
ﾊﾞﾅｯﾊｸｳｶﾝ	バナッハ空間	名詞
ﾊﾞﾝｱﾚﾝﾀｲ	バンアレン帯	名詞
ﾊﾞﾝﾌﾞﾚｯｸｼﾞｮｳｼﾞｾｲ	バンブレック常磁性	名詞
ﾊﾞﾝﾃﾞｸﾞﾗｰﾌｶｿｸｷ	バンデグラーフ加速器	名詞
ﾊﾞﾝﾄﾞｹｲ	バンド系	名詞
ﾊﾞﾝﾄﾞﾉｹﾞﾝﾃﾝ	バンドの原点	名詞
ﾊﾞﾝﾄﾞﾉｾﾞﾛｾﾝ	バンドのゼロ線	名詞
ﾊﾞﾝﾄﾞﾔｰﾝﾃﾗｰｺｳｶ	バンドヤーン・テラー効果	名詞
ﾊﾞｰﾈｯﾄｺｳｶ	バーネット効果	名詞
ﾊﾞｰﾆﾔ	バーニヤ	名詞
ﾊﾞﾝｷｮｸｶﾝ	板極管	名詞
ﾊﾞﾉﾊﾝｻﾖｳ	場の反作用	名詞
ﾊﾞﾉﾘﾛﾝ	場の理論	名詞
ﾊﾞﾉﾘｮｳｼﾛﾝ	場の量子論	名詞
ﾊﾞﾉﾂﾖｻ	場の強さ	名詞
ﾊﾞﾝﾊﾟﾂｾｲｺｳｶ	晩発性効果	名詞
ﾊﾞﾝﾊﾟﾂｾｲﾎｳｼｬｾﾝ	晩発性放射線	名詞
ﾊﾞﾝﾋﾟｰﾄｰﾗｽ	バンピートーラス	名詞
ﾊﾞﾝﾌﾟﾃﾞﾝｼﾞｼｬｸ	バンプ電磁石	名詞
ﾊﾞｰﾝｽﾀｲﾝﾊ	バーンスタイン波	名詞
ﾊﾞﾝﾁ	バンチ	名詞
ﾊﾞﾝﾁｬｰ	バンチャー	名詞
ﾊﾞﾗｸﾀｰ	バラクター	名詞
ﾊﾞﾗｰﾘﾋﾃﾝﾘﾛﾝ	バラー・リヒテン理論	名詞
ﾊﾞﾗｽｺｳｶ	バラス効果	名詞
ｷﾄﾞｳﾌﾞﾝﾚﾂ	軌道分裂	名詞
ﾊﾞﾚｰｷﾄﾞｳﾌﾞﾝﾚﾂ	バレー軌道分裂	名詞
ﾊﾞﾚｽｸｶﾞｰﾝｾｲﾚﾅｰﾄﾞ	バレスク・ガーンセイ・レナード	人名
ｼｮｳﾄﾂｺｳ	衝突項	名詞
ﾊﾞﾘｺﾝ	バリコン	名詞
ﾊﾞﾘｵﾝ	バリオン	名詞
ｼﾞｭｳﾘｭｳｼ	重粒子	名詞
ﾊﾞﾘｵﾆｳﾑ	バリオニウム	名詞
ﾊﾞﾘｵﾝｷｮｳﾒｲ	バリオン共鳴	名詞
ﾊﾞﾘｵﾝｽｳ	バリオン数	名詞
ﾊﾞﾘｽﾃｨｯｸﾓｰﾄﾞ	バリスティックモード	名詞
ﾊﾞﾙｸｹﾞｯﾀｰ	バルクゲッター	名詞
ﾊﾞﾙｸﾊｳｾﾞﾝｽｳ	バルクハウゼン数	名詞
ﾊﾞﾙｸﾊｳｾﾞﾝｸﾙﾂ	バルクハウゼン・クルツ	人名
ﾊﾞﾙﾏｰｹｲﾚﾂ	バルマー系列	名詞
ﾊﾞﾙｰﾆﾝｸﾞﾌｱﾝﾃｲｾｲ	バルーニング不安定性	名詞
ﾊﾞｰｽﾀｲﾝﾓｽｺｳｶ	バースタイン・モス効果	名詞
ﾊﾞｰｽﾄ	バースト	名詞
ﾊﾞｰﾃｯｸｽ	バーテックス	名詞
ﾊﾞｰﾃｯｸｽﾉｸﾘｺﾐ	バーテックスのくりこみ	名詞
ﾊﾞｰﾄﾚｯﾄﾘｮｸ	バートレット力	名詞
ﾊﾞｯﾁｼｮﾘ	バッチ処理	名詞
ﾊﾞｳｼﾝｶﾞｰｺｳｶ	バウシンガー効果	名詞
ﾊﾞｰｾﾞﾙｷﾔｸ	バーゼル規約	名詞
ﾍﾞｶﾞｰﾄﾞｿｸ	ベガード則	名詞
ﾍﾞｲｽﾞﾉﾃｲﾘ	ベイズの定理	名詞
ﾍﾞｲｽﾞﾘｭｳｽｲｿｸ	ベイズ流推測	名詞
ﾍﾞｯｺｿｳｶﾝｶﾝｽｳ	別個相関関数	名詞
ﾍﾞｯｸﾏﾝｵﾝﾄﾞｹｲ	ベックマン温度計	名詞
ﾍﾞｸﾄﾙｶﾚﾝﾄ	ベクトルカレント	名詞
ﾍﾞｸﾄﾙｾｷ	ベクトル積	名詞
ﾍﾞﾅｰﾙﾀｲﾘｭｳ	ベナール対流	名詞
ﾍﾞﾝﾍﾞﾂｷ	弁別器	名詞
ﾍﾞﾝﾁｭﾘｶﾝ	ベンチュリ管	名詞
ﾍﾞﾚｯｸﾉﾎｼｮｳﾊﾞﾝ	ベレックの補償板	名詞
ﾍﾞﾛｿﾞﾌｼﾞｬﾎﾞﾁﾝｽｷｰ	ベロゾフ・ジャボチンスキー	人名
ﾍﾞﾛｰｽﾞ	ベローズ	名詞
ﾍﾞﾙﾃﾞﾃｲｽｳ	ベルデ定数	名詞
ﾍﾞﾙｸﾞﾊﾞﾚｰﾎｳ	ベルグ・バレー法	名詞
ﾍﾞｰﾙﾉﾎｳｿｸ	ベールの法則	名詞
ﾍﾞﾙﾉﾌﾄｳｼｷ	ベルの不等式	名詞
ﾍﾞﾙﾇｰｲ	ベルヌーイ	人名
ﾍﾞﾙﾇｰｲ	Verneuil	人名
ﾍﾞﾙﾇｰｲ	Berunoulli	人名
ﾍﾞﾙﾇｰｲﾎｳ	ベルヌーイ法	名詞
ﾍﾞﾙｻｱﾂｹｲ	ベル差圧系計	名詞
ﾍﾞﾙﾄｷﾃﾞﾝｷ	ベルト起電機	名詞
ﾍﾞﾙｼﾞｬｰ	ベルジャー	名詞
ﾍﾞｯｾﾙｶﾝｽｳ	ベッセル関数	名詞
ﾍﾞｰﾀﾄﾛﾝ	ベータトロン	名詞
ﾍﾞｰﾀﾄﾛﾝｼﾝﾄﾞｳ	ベータトロン振動	名詞
ﾍﾞｰﾃ	ベーテ	人名
ﾍﾞｰﾃﾌﾞﾛｯﾎﾉｼｷ	ベーテ・ブロッホの式	名詞
ﾍﾞｰﾃｺﾞｰﾙﾄﾞｽﾄﾝ	ベーテ・ゴールドストン	人名
ﾍﾞｰﾃﾊﾙｾﾝﾉﾘﾛﾝ	ベーテ・ハルセンの理論	名詞
ﾍﾞｰﾃｷﾝｼﾞ	ベーテ近似	名詞
ﾍﾞｰﾃｻﾙﾋﾟｰﾀｰ	ベーテ・サルピーター	人名
ﾋﾞｱﾂｹｲ	微圧計	名詞
ﾋﾞﾌﾞﾝﾀﾞﾝﾒﾝｾｷ	微分断面積	名詞
ﾋﾞﾌﾞﾝｶｻﾅﾘ	微分重なり	名詞
ﾋﾞｴﾉﾌﾞﾝｶﾂﾚﾝｽﾞ	ビエの分割レンズ	名詞
ﾋﾞｰﾑﾌﾞﾝｶﾂｷ	ビーム分割器	名詞
ﾋﾞｰﾑﾌﾞﾝﾘｷ	ビーム分離器	名詞
ﾋﾞｰﾑﾌﾞﾝｾｷｷ	ビーム分析器	名詞
ﾋﾞｰﾑﾌｫｲﾙﾌﾞﾝｺｳ	ビームフォイル分光	名詞
ﾋﾞｰﾑﾌｶ	ビーム負荷	名詞
ﾋﾞｰﾑｺｳｶﾞｸ	ビーム光学	名詞
ﾋﾞｰﾑﾌﾟﾗｽﾞﾏｹｲ	ビームプラズマ系	名詞
ﾋﾞｰﾑｽｲﾝｶﾞｰ	ビームスインガー	名詞
ﾋﾞｰﾑｽﾌﾟﾘｯﾀｰ	ビームスプリッター	名詞
ﾋﾞｰﾑﾄﾘﾀﾞｼ	ビーム取りだし	名詞
ﾋﾞｰﾑﾕｿｳ	ビーム輸送	名詞
ﾋﾞｹｯｼｮｳ	微結晶	名詞
ﾋﾞｷｱﾂｹｲ	微気圧計	名詞
ﾋﾞｯｶｰｽｶﾀｻ	ビッカース硬さ	名詞
ﾋﾞﾝｶﾞﾑｿｾｲ	ビンガム塑性	名詞
ﾋﾞｵｻﾊﾞｰﾙﾉﾎｳｿｸ	ビオ・サバールの法則	名詞
ﾋﾞﾗﾑﾋﾞﾌｳｹｲ	ビラム微風計	名詞
ﾋﾞﾘｱﾙ	ビリアル	名詞
ﾋﾞﾘｱﾙｹｲｽｳ	ビリアル係数	名詞
ﾋﾞﾘｱﾙﾃｲﾘ	ビリアル定理	名詞
ﾋﾞﾙﾄﾞｱｯﾌﾟｹｲｽｳ	ビルドアップ係数	名詞
ﾋﾞﾘｮｳｾﾝﾘｮｳｿｸﾃｲ	微量線量測定	名詞
ﾋﾞﾘｮｳﾃﾝﾋﾞﾝ	微量てんびん	名詞
ﾋﾞﾘｭｳｼ	微粒子	名詞
ﾋﾞｻｲｺｳｿﾞｳ	微細構造	名詞
ﾋﾞｻｲｺｳｿﾞｳﾃｲｽｳ	微細構造定数	名詞
ﾋﾞｼﾃｷ	微視的	連体詞
ﾋﾞｼﾃｷﾌｱﾝﾃｲｾｲ	微視的不安定性	名詞
ﾋﾞｼｮｳｷﾞｬｯﾌﾟ	微小ギャップ	名詞
ﾋﾞｼｮｳｺｳｶﾞｸ	微小光学	名詞
ﾋﾞｼｮｳｼﾝﾄﾞｳ	微小振動	名詞
ﾋﾞｼｮｳｼｮｳﾃﾝXｾﾝｶﾝ	微小焦点X線管	名詞
ﾋﾞｯﾀｰｽﾞｹｲ	ビッター図形	名詞
ﾋﾞﾜｸｾｲｾﾂ	微惑星説	名詞
ﾋﾞﾔﾝｷﾉｺｳｼｷ	ビヤンキの公式	名詞
ﾎﾞｰ	ボー	名詞
ﾎﾞｰｱﾌｧﾝﾘｭｰｴﾝﾉﾃｲﾘ	ボーア・ファンリューエンの定理	名詞
ﾎﾞｰｱ	Bohr	人名
ﾎﾞｰｱ	ボーア	人名
ﾎﾞｰｱﾊﾝｹｲ	ボーア半径	名詞
ﾎﾞｰｱﾉｹﾞﾝｼﾓｹｲ	ボーアの原子模型	名詞
ﾎﾞｰｱﾉﾘｮｳｼｼﾞｮｳｹﾝ	ボーアの量子条件	名詞
ﾎﾞｰｱﾉﾃｲﾘ	ボーアの定理	名詞
ﾎﾞｰｱｿｸﾄﾞ	ボーア速度	名詞
ﾎﾞｰｱｼﾞｼ	ボーア磁子	名詞
ﾎﾞｰｱｿﾞﾝﾏｰﾌｪﾙﾄ	ボーア・ゾンマーフェルト	名詞
ﾘｮｳｼｼﾞｮｳｹﾝ	量子条件	名詞
ﾎﾞｰﾃﾞﾉﾎｳｿｸ	ボーデの法則	名詞
ﾎﾞｰﾄﾞｾﾝｽﾞ	ボード線図	名詞
ﾎﾞｺﾞﾘｭｰﾎﾞﾌﾍﾝｶﾝ	ボゴリューボフ変換	名詞
ﾎﾞｲﾄﾞ	ボイド	名詞
ﾎﾞｲﾄﾞｹｲｽｳ	ボイド係数	名詞
ﾎﾞｲﾄﾞｺｳｼ	ボイド格子	名詞
ﾎﾞｲﾙﾏﾘｵｯﾄﾉﾎｳｿｸ	ボイル・マリオットの法則	名詞
ﾎﾞｲﾙﾉﾎｳｿｸ	ボイルの法則	名詞
ﾎﾞｲﾙｵﾝﾄﾞ	ボイル温度	名詞
ﾎﾞｲﾙｼｬﾙﾙﾉﾎｳｿｸ	ボイル・シャルルの法則	名詞
ﾎﾞｲﾄﾗｰﾌｧﾉｺｳｶ	ボイトラー・ファノ効果	名詞
ﾎﾞｲﾄﾗｰﾏｳﾝﾃｨﾝｸﾞ	ボイトラーマウンティング	名詞
ﾎﾞｶﾝｽｳ	母関数	名詞
ﾎﾞｯｸｽｶｰｾｷﾌﾞﾝｷ	ボックスカー積分器	名詞
ﾎﾞｰﾒﾄﾞ	ボーメ度	名詞
ﾎﾞｰﾑｶｸｻﾝ	ボーム拡散	名詞
ﾎﾞｰﾑﾊﾞｲﾝｽﾞﾘﾛﾝ	ボーム・バインズ理論	名詞
ﾎﾞﾝﾍﾞﾈﾂﾘｮｳｹｲ	ボンベ熱量計	名詞
ﾎﾞﾝﾄﾞﾀﾞｲｵｰﾄﾞ	ボンドダイオード	名詞
ﾎﾞﾝﾄﾞｺｳﾀｲ	ボンド交代	名詞
ﾎﾞﾚﾙｿｳﾜｶﾉｳ	ボレル総和可能	名詞
ﾎﾞﾛﾒｰﾀｰ	ボロメーター	名詞
ﾎﾞﾙﾀﾞﾉﾌｷﾀﾞｼｸﾞﾁ	ボルダの吹出し口	名詞
ﾎﾞﾙﾀﾞﾉﾌﾘｺ	ボルダの振り子	名詞
ﾎﾞﾙﾄﾞﾆｰﾋﾟｰｸ	ボルドニーピーク	名詞
ﾎﾞﾙﾏﾝｷｭｳｼｭｳ	ボルマン吸収	名詞
ﾎﾞﾙﾏﾝｾﾝ	ボルマン線	名詞
ﾎﾞﾙﾝｶﾙﾏﾝ	ボルン・カルマン	人名
ｷｮｳｶｲｼﾞｮｳｹﾝ	境界条件	名詞
ﾎﾞﾙﾝｷﾝｼﾞ	ボルン近似	名詞
ﾎﾞﾙﾝﾏｲﾔｰﾎﾟﾃﾝｼｬﾙ	ボルン・マイヤーポテンシャル	名詞
ﾎﾞﾙﾝｵｯﾍﾟﾝﾊｲﾏｰ	ボルン・オッペンハイマー	人名
ﾎﾞﾙﾀﾃﾞﾝﾁ	ボルタ電池	名詞
ﾎﾞﾙﾀﾒｰﾀｰ	ボルタメーター	名詞
ﾎﾞﾙﾀﾝﾒﾄﾘｰ	ボルタンメトリー	名詞
ﾎﾞﾙﾂﾏﾝ	Boltzmann	人名
ﾎﾞﾙﾂﾏﾝ	ボルツマン	人名
ﾎﾞﾙﾂﾏﾝﾌﾞﾝﾌﾟ	ボルツマン分布	名詞
ﾎﾞﾙﾂﾏﾝｲﾝｼ	ボルツマン因子	名詞
ﾎﾞﾙﾂﾏﾝﾄｳｹｲ	ボルツマン統計	名詞
ﾎﾞﾙﾂﾏﾝﾕｿｳﾎｳﾃｲｼｷ	ボルツマン輸送方程式	名詞
ﾎﾞｳｼﾝｿｳﾁ	防振装置	名詞
ﾎﾞｿﾝ	ボソン	名詞
ﾎﾞｿﾝﾃﾝｶｲ	ボソン展開	名詞
ﾎﾞｰｽ	Bose	人名
ﾎﾞｰｽ	ボース	人名
ﾎﾞｰｽｱｲﾝｼｭﾀｲﾝ	ボース・アインシュタイン	人名
ﾎﾞｰｽﾘｭｳﾀｲ	ボース流体	名詞
ﾎﾞｰｽﾄｳｹｲ	ボース統計	名詞
ﾎﾞﾄﾑﾘｭｳｼ	ボトム粒子	名詞
ﾎﾞｳﾁｮｳｹｲ	膨張計	名詞
ﾎﾞｳﾁｮｳｹｲｽｳ	膨張係数	名詞
ﾎﾞﾔｹﾊﾞﾝﾄﾞ	ぼやけバンド	名詞
ﾎﾞｳｼﾞｮｳﾓｹｲ	棒状模型	名詞
ﾌﾞﾌﾞﾝﾊ	部分波	名詞
ﾌﾞﾌﾞﾝﾊﾊﾞ	部分幅	名詞
ﾌﾞﾌﾞﾝﾍﾝｺｳ	部分偏光	名詞
ﾌﾞﾌﾞﾝｺｳｼ	部分格子	名詞
ﾌｸｺｳｼ	副格子	名詞
ﾌﾞﾌﾞﾝｺｳｼｼﾞｶ	部分格子磁化	名詞
ﾌｸｺｳｼｼﾞｶ	副格子磁化	名詞
ﾌﾞﾌﾞﾝｼｮｳｼｬ	部分照射	名詞
ﾌﾞﾌﾞﾝﾃﾝｲ	部分転位	名詞
ﾌﾞﾝｱﾂ	分圧	名詞
ﾌﾞﾝｱﾂｷ	分圧器	名詞
ﾌﾞﾝｱﾂﾉﾎｳｿｸ	分圧の法則	名詞
ﾌﾞﾝﾍﾞﾂｹｯｼｮｳｶ	分別結晶化	名詞
ﾌﾞﾝｲｷ	分域	名詞
ﾌﾞﾝｲｷﾍｷ	分域壁	名詞
ﾌﾞﾝｲｷｺｳｿﾞｳ	分域構造	名詞
ﾌﾞﾝｶｲｾﾝﾀﾞﾝｵｳﾘｮｸ	分解せん断応力	名詞
ﾌﾞﾝｶｲｼﾞｶﾝ	分解時間	名詞
ﾌﾞﾝｶﾂｼｮｳｼｬ	分割照射	名詞
ﾌﾞﾝｷﾋ	分岐比	名詞
ﾌﾞﾝｺｳﾌﾞﾝｾｷ	分光分析	名詞
ﾌﾞﾝｺｳｶﾞｸｲﾝｼ	分光学因子	名詞
ﾌﾞﾝｺｳｶﾞｸﾃｷ	ﾌﾞﾝｺｳｶﾞｸﾃｷ	形容動詞
ﾍﾝｲﾎｳｿｸ	変移法則	名詞
ﾌﾞﾝｺｳﾍﾝｺｳｹｲ	分光偏光計	名詞
ﾌﾞﾝｺｳｶﾝﾄﾞ	分光感度	名詞
ﾌﾞﾝｺｳｺｳﾄﾞｹｲ	分光光度計	名詞
ﾌﾞﾝｺｳﾚﾝｾｲ	分光連星	名詞
ﾌﾞﾝｺｳｿｯｺｳ	分光測光	名詞
ﾌﾞﾝｺｳｼｬｼﾝｷ	分光写真器	名詞
ﾌﾞﾝｷｮｸﾃﾞﾝｶ	分極電荷	名詞
ﾌﾞﾝｷｮｸｷﾄﾞｳ	分極軌道	名詞
ﾌﾞﾝｷｮｸﾘﾂ	分極率	名詞
ﾌﾞﾝｷｮｸﾘｮｸ	分極力	名詞
ﾌﾞﾝｷｮｸｻﾞｲ	分極剤	名詞
ﾌﾞﾝﾊﾟｲｶﾝｽｳ	分配関数	名詞
ﾌﾞﾝﾊﾟｲｿｸ	分配則	名詞
ﾌﾞﾝﾊﾟｲﾉﾎｳｿｸ	分配の法則	名詞
ﾌﾞﾝﾊﾟｲｻﾞﾂｵﾝ	分配雑音	名詞
ﾌﾞﾝﾊﾟｲｿﾞｳﾌｸｷ	分配増幅器	名詞
ﾌﾞﾝﾌﾟｶﾞﾀｲｵﾝﾎﾟﾝﾌﾟ	分布型イオンポンプ	名詞
ﾌﾞﾝﾌﾟｷｶﾝｶﾞﾀﾚｰｻﾞｰ	分布帰還型レーザー	名詞
ﾌﾞﾝﾌﾟﾃｲｽｳｶｲﾛ	分布定数回路	名詞
ﾌﾞﾝﾌﾟｿﾞｳﾌｸｷ	分布増幅器	名詞
ﾌﾞﾝﾚﾂｶﾞﾀﾊｲﾁ	分裂型配置	名詞
ﾌﾞﾝﾚﾂﾍﾝ	分裂片	名詞
ﾌﾞﾝﾘｴﾈﾙｷﾞｰ	分離エネルギー	名詞
ﾌﾞﾝﾘｹﾞﾝｼ	分離原子	名詞
ﾌﾞﾝﾘｷﾄﾞｳｶﾞﾀ	分離軌道型	名詞
ﾌﾞﾝﾛ	分路	名詞
ﾌﾞﾝｻﾝﾄﾞ	分散度	名詞
ﾌﾞﾝｻﾝｹﾞﾝｼｮｳ	分散現象	名詞
ﾌﾞﾝｻﾝﾊﾊﾞ	分散幅	名詞
ﾌﾞﾝｻﾝｶﾝｹｲ	分散関係	名詞
ﾌﾞﾝｻﾝｹｲ	分散系	名詞
ﾌﾞﾝｻﾝｺｳｶ	分散硬化	名詞
ﾌﾞﾝｻﾝﾒﾝ	分散面	名詞
ﾌﾞﾝｻﾝﾉｳ	分散能	名詞
ﾌﾞﾝｻﾝﾘｮｸ	分散力	名詞
ﾌﾞﾝｻﾝｾｲ	分散性	名詞
ﾌﾞﾝｻﾝｼｷ	分散式	名詞
ﾌﾞﾝｻﾝﾃﾝ	分散点	名詞
ﾌﾞﾝｾｷﾃﾞﾝｼﾞｼｬｸ	分析電磁石	名詞
ﾌﾞﾝｾｷｷ	分析器	名詞
ﾌﾞﾝｾｷﾉｳ	分析能	名詞
ﾌﾞﾝｼｱｯｼｭｸﾘﾂ	分子圧縮率	名詞
ﾌﾞﾝｼﾊﾞ	分子場	名詞
ﾌﾞﾝｼﾊﾞｷﾝｼﾞ	分子場近似	名詞
ﾌﾞﾝｼﾋﾞｰﾑ	分子ビーム	名詞
ﾌﾞﾝｼﾊﾝｹｲ	分子半径	名詞
ﾌﾞﾝｼﾊﾝﾃﾝ	分子反転	名詞
ﾌﾞﾝｼｲｵﾝ	分子イオン	名詞
ﾌﾞﾝｼｶｶﾞｸ	分子科学	名詞
ﾌﾞﾝｼｶｲﾃﾝ	分子回転	名詞
ﾌﾞﾝｼｶﾝﾘｮｸ	分子間力	名詞
ﾌﾞﾝｼｶﾝｿｳｺﾞｻﾖｳ	分子間相互作用	名詞
ﾌﾞﾝｼｹｯｼｮｳ	分子結晶	名詞
ﾌﾞﾝｼｷﾄﾞｳ	分子軌道	名詞
ﾌﾞﾝｼｷﾄﾞｳﾎｳ	分子軌道法	名詞
ﾌﾞﾝｼｷﾄﾞｳｶﾝｽｳ	分子軌道関数	名詞
ﾌﾞﾝｼｺｳｿﾞｳ	分子構造	名詞
ﾌﾞﾝｼｸｯｾﾂ	分子屈折	名詞
ﾌﾞﾝｼﾅｲｶｲﾃﾝ	分子内回転	名詞
ﾅｲﾌﾞｶｲﾃﾝ	内部回転	名詞
ﾌﾞﾝｼﾈﾝｾｲ	分子粘性	名詞
ﾌﾞﾝｼｵﾝｷｮｳｶﾞｸ	分子音響学	名詞
ﾌﾞﾝｼﾘｭｳ	分子流	名詞
ﾌﾞﾝｼｾｲﾌﾞﾂｶﾞｸ	分子生物学	名詞
ﾌﾞﾝｼｾｲｹｯｼｮｳ	分子性結晶	名詞
ﾌﾞﾝｼｾｷﾌﾞﾝ	分子積分	名詞
ﾌﾞﾝｼｾﾝｴﾋﾟｷﾀｼｰ	分子線エピキタシー	名詞
ﾌﾞﾝｼｾﾝﾒｰｻﾞｰ	分子線メーザー	名詞
ﾌﾞﾝｼｾﾝｼﾞｷｷｮｳﾒｲ	分子線磁気共鳴	名詞
ﾌﾞﾝｼｼﾝﾄﾞｳ	分子振動	名詞
ﾌﾞﾝｼﾀｲｾｷ	分子体積	名詞
ﾌﾞﾝｼﾀｲｼｮｳ	分子対称	名詞
ﾌﾞﾝｼﾁｶﾝﾎｳ	分子置換法	名詞
ﾌﾞﾝｼｳﾝﾄﾞｳﾛﾝ	分子運動論	名詞
ﾌﾞﾝｼｿﾞｳ	分子像	名詞
ﾌﾞﾝｼｿﾞｳﾌｸｷ	分子増幅器	名詞
ﾌﾞﾝｼｼﾞｮｳｹﾝ	分子条件	名詞
ﾌﾞﾝｼﾘｮｳｼﾎｰﾙｺｳｶ	分子量子ホール効果	名詞
ﾌﾞﾝｽｳﾄｳｹｲ	分数統計	名詞
ﾌﾞﾝｽｳﾁｮｳﾊ	分数調波	名詞
ﾌﾞﾝｼｭｳﾊ	分周波	名詞
ﾌﾞﾝｼｭｳｷ	分周器	名詞
ﾌﾞﾝｼｭｳｵﾝ	分周音	名詞
ﾌﾞﾝｼｭｳｼﾝﾄﾞｳ	分周振動	名詞
ﾌﾞﾗﾍﾞｺｳｼ	ブラベ格子	名詞
ﾌﾞﾗﾍﾞｺｳｼﾃﾝ	ブラベ格子点	名詞
ﾌﾞﾗｯｸﾞｸﾞﾚｲﾉｹﾞﾝﾘ	ブラッググレイの原理	名詞
ﾌﾞﾗｯｸﾞ	Bragg	人名
ﾌﾞﾗｯｸﾞ	ブラッグ	人名
ﾌﾞﾗｯｸﾞﾊﾝｼｬ	ブラッグ反射	名詞
ﾌﾞﾗｯｸﾞｶｲｾﾂ	ブラッグ回折	名詞
ﾌﾞﾗｯｸﾞｳｨﾘｱﾑｽｷﾝｼﾞ	ブラッグ・ウィリアムス近似	名詞
ﾌﾞﾗｲﾄ	ブライト	人名
ﾌﾞﾗｲﾄﾊﾐﾙﾄﾆｱﾝ	ブライトハミルトニアン	名詞
ﾌﾞﾗｲﾄﾈｽ	ブライトネス	名詞
ﾌﾞﾗｲﾄｳｨｸﾞﾅｰﾉｼｷ	ブライト・ウィグナーの式	名詞
ﾌﾞﾗｹｯﾄ	ブラケット	名詞
ﾌﾞﾗｹｯﾄｹｲﾚﾂ	ブラケット系列	名詞
ﾌﾞﾗｯｸﾊﾞｰﾝﾉﾌﾘｺ	ブラックバーンの振り子	名詞
ﾌﾞﾗﾝﾄﾊﾞｲｻﾗ	ブラント・バイサラ	人名
ﾌﾞﾗｿﾌﾎｳﾃｲｼｷ	ブラソフ方程式	名詞
ﾌﾞﾗｼﾞｳｽ	ブラジウス	人名
ﾌﾞﾗｼﾞｳｽﾉｺｳｼｷ	ブラジウスの公式	名詞
ﾌﾞﾗｼﾞｳｽﾉﾅｶﾞﾚ	ブラジウスの流れ	名詞
ﾌﾞﾚｲﾄﾝｻｲｸﾙ	ブレイトンサイクル	名詞
ﾌﾞﾚｰｽｹｰﾗｰ	ブレース・ケーラー	名詞
ﾌﾞﾚｰｽﾞ	ブレーズ	名詞
ﾌﾞﾚｰｽﾞﾄﾞｶｲｾﾂｺｳｼ	ブレーズド回折格子	名詞
ﾌﾞﾚｰｽﾞﾊﾁｮｳ	ブレーズ波長	名詞
ﾌﾞﾚｰｽﾞｶｸ	ブレーズ角	名詞
ﾌﾞﾘｱｰｽﾞｺｳｶ	ブリアーズ効果	名詞
ﾌﾞﾘｰﾀﾞｰ	ブリーダー	名詞
ﾌﾞﾘﾈﾙｶﾀｻ	ブリネル硬さ	名詞
ﾌﾞﾘｽﾀｰ	ブリスター	名詞
ﾌﾞﾘｽﾀﾘﾝｸﾞ	ブリスタリング	名詞
ﾌﾞﾘﾕｱﾝｲｷ	ブリユアン域	名詞
ﾌﾞﾘﾕｱﾝ	ブリユアン	人名
ﾌﾞﾘﾕｱﾝﾀｲ	ブリユアン帯	名詞
ﾌﾞﾘﾕｱﾝｶﾝｽｳ	ブリユアン関数	名詞
ﾌﾞﾘﾕｱﾝｻﾝﾗﾝ	ブリユアン散乱	名詞
ﾌﾞﾘﾕｱﾝﾃｲﾘ	ブリユアン定理	名詞
ﾌﾞﾘｯｼﾞﾎｳ	ブリッジ法	名詞
ﾌﾞﾘｯｼﾞﾏﾝﾎｳ	ブリッジマン法	名詞
ﾌﾞﾛｰﾃﾞｨｰﾌﾞﾝﾌﾟ	ブローディー分布	名詞
ﾌﾞﾛｯﾎﾍｷ	ブロッホ壁	名詞
ﾌﾞﾛｯﾎ	Bloch	人名
ﾌﾞﾛｯﾎ	ブロッホ	人名
ﾌﾞﾛｯﾎｶﾝｽｳ	ブロッホ関数	名詞
ﾌﾞﾛｯﾎｷﾄﾞｳ	ブロッホ軌道	名詞
ﾌﾞﾛｯﾎﾉﾙﾄﾞｼﾞｰｸ	ブロッホ・ノルドジーク	人名
ﾌﾞﾛｯﾎﾉﾃｲﾘ	ブロッホの定理	名詞
ﾌﾞﾛｯｷﾝｸﾞ	ブロッキング	名詞
ﾌﾞﾛｯｷﾝｸﾞﾃﾞｨｯﾌﾟ	ﾌﾞﾛｯｷﾝｸﾞﾃﾞｨｯﾌﾟ	名詞
ﾌﾞﾛｯｷﾝｸﾞﾊｯｼﾝｷ	ブロッキング発振器	名詞
ﾌﾞﾛｯｸｹﾞｰｼﾞ	ブロックゲージ	名詞
ｷｮｳｼﾞｭｳｺﾞｳﾀｲ	共重合体	名詞
ﾌﾞﾛｯｸｾﾝｽﾞ	ブロック線図	名詞
ﾌﾞﾛｰｸﾝｼﾝﾒﾄﾘｰ	ブロークンシンメトリー	名詞
ﾌﾞｰﾙﾀﾞｲｽｳ	ブール代数	名詞
ﾌﾞﾙﾄﾞﾝｶﾝｱﾂﾘｮｸｹｲ	ブルドン管圧力計	名詞
ﾌﾞﾙｯｸﾅｰﾘﾛﾝ	ブルックナー理論	名詞
ﾌﾞﾙﾏｲﾔｰｻｲｸﾙ	ブルマイヤーサイクル	名詞
ﾌﾞﾙｰｼﾌﾄ	ブルーシフト	名詞
ﾌﾞｰﾙｿｸ	ブール束	名詞
ﾌﾞﾙｰｽﾀｰ	Brewster	人名
ﾌﾞﾙｰｽﾀｰ	ブルースター	人名
ﾌﾞﾙｰｽﾀｰｶｸ	ブルースター角	名詞
ﾌﾞﾙｰｽﾀｰﾏﾄﾞ	ブルースター窓	名詞
ﾌﾞﾙｰｽﾀｰﾉﾎｳｿｸ	ブルースターの法則	名詞
ﾌﾞﾙｰｽﾀｰﾉｶﾝｼｮｳｼﾞﾏ	ブルースターの干渉じま	名詞
ﾌﾞｼﾈｽｸｷﾝｼﾞ	ブシネスク近似	名詞
ﾌﾞｯｼﾂﾊ	物質波	名詞
ﾌﾞｯｼﾂﾌﾒﾂﾉﾎｳｿｸ	物質不滅の法則	名詞
ﾌﾞｰｽﾄ	ブースト	名詞
ﾌﾞｰﾄｽﾄﾗｯﾌﾟ	ブートストラップ	名詞
ﾌﾞｯﾀｲﾊ	物体波	名詞
ﾌﾞｯﾀｲｺﾃｲｻﾞﾋｮｳｹｲ	物体固定座標系	名詞
ﾌﾞﾂﾘｶｶﾞｸ	物理化学	名詞
ﾌﾞﾂﾘｺｳｶﾞｸ	物理光学	名詞
ﾌﾞﾂﾘｷｭｳﾁｬｸ	物理吸着	名詞
ﾌﾞﾂﾘｿｯｺｳ	物理測光	名詞
ﾌﾞｼﾞｮﾙｹﾝｽｹｰﾘﾝｸﾞ	ブジョルケンスケーリング	名詞
ﾋﾞｭﾚｯﾄ	ビュレット	名詞
ｶｲ2ﾌﾞﾝﾌﾟ	χ2分布	名詞
ｶｲ2ﾌﾞﾝﾌﾟ	$\chi^2$分布	名詞
ｶｲ2ﾌﾞﾝﾌﾟ	\chi^2分布	名詞
ｶｲ2ﾌｨｯﾄ	χ2フィット	名詞
ｶｲ2ﾌｨｯﾄ	$\chi^2$フィット	名詞
ｶｲ2ﾌｨｯﾄ	\chi^2フィット	名詞
Cｱﾈﾂﾃﾞﾝﾂｲ	CA熱電対	名詞
CFPｹｲｽｳ	CFP係数	名詞
Cｶﾞﾀﾃﾞﾝｼﾞｼｬｸ	C型電磁石	名詞
CGLｷﾝｼﾞ	CGL近似	名詞
CGSﾀﾝｲｹｲ	CGS単位系	名詞
Cﾌﾍﾝｾｲ	C不変性	名詞
Cｲﾎｳ	CI法	名詞
Cｷｭｳｿﾞｳｸﾞｸ	C級増幅	名詞
Cﾏﾀﾞｲｱｸﾞﾗﾑ	CMAダイアグラム	名詞
Cﾝﾄﾞﾎｳ	CNDO法	名詞
Cﾉｻｲｸﾙ	CNOサイクル	名詞
CPﾌﾍﾝｾｲ	CP不変性	名詞
CPﾉﾔﾌﾞﾚ	CPのやぶれ	名詞
CPｯﾃｲﾘ	CPT定理	名詞
CRCﾈﾂﾃﾞﾝﾂｲ	CRC熱電対	名詞
Cｽｳ	C数	名詞
Cｽｳ	{\itC}数	名詞
Cﾂｧｸﾀｲ	CT錯体	名詞
CVCﾘﾛﾝ	CVC理論	名詞
CWﾊｯｼﾝ	CW発振	名詞
CWﾚｰｻﾞｰ	CWレーザー	名詞
ﾃﾞﾙﾀｴｺｳｶ	ΔE効果	名詞
ﾃﾞﾙﾀｴｺｳｶ	${\mit\Delta}E$効果	名詞
ﾃﾞﾙﾀｴｺｳｶ	{\mit\Delta}E効果	名詞
ﾃﾞﾙﾀｶﾝｽｳ	δ関数	名詞
ﾃﾞﾙﾀｶﾝｽｳ	$\delta$関数	名詞
ﾃﾞﾙﾀｶﾝｽｳ	\delta関数	名詞
ﾃﾞﾙﾀｶﾝｽｳｼｷｷｶｸｶ	δ関数式規格化	名詞
ﾃﾞﾙﾀｶﾝｽｳｼｷｷｶｸｶ	$\delta$関数式規格化	名詞
ﾃﾞﾙﾀｶﾝｽｳｼｷｷｶｸｶ	\delta関数式規格化	名詞
ﾃﾞﾙﾀｹｯｾﾝ	Δ結線	名詞
ﾃﾞﾙﾀｹｯｾﾝ	$\Delta$結線	名詞
ﾃﾞﾙﾀｹｯｾﾝ	\Delta結線	名詞
ﾃﾞﾙﾀｷﾄﾞｳ	δ軌道	名詞
ﾃﾞﾙﾀｷﾄﾞｳ	$\delta$軌道	名詞
ﾃﾞﾙﾀｷﾄﾞｳ	\delta軌道	名詞
ﾃﾞﾙﾀｾﾝ	δ線	名詞
ﾃﾞﾙﾀｾﾝ	$\delta$線	名詞
ﾃﾞﾙﾀｾﾝ	\delta線	名詞
ﾀﾞﾍﾝｶﾝｷ	D-A変換器	名詞
Dﾊﾞﾝﾄﾞ	dバンド	名詞
DCｱCｺﾝﾊﾞｰﾀｰ	DC-ACコンバーター	名詞
DFｺｳｶﾝｿｳｺﾞｻﾖｳ	d-f交換相互作用	名詞
Dｷﾄﾞｳ	d軌道	名詞
Dﾅｼｭｳﾌｸ	DNA修復	名詞
Dｾﾝ	D線	名詞
ﾀﾞﾋﾞﾄﾞﾌﾌﾞﾝﾚﾂ	ダビドフ分裂	名詞
ﾀﾞﾌﾞﾙﾍﾞｰｽﾀﾞｲｵｰﾄﾞ	ダブルベースダイオード	名詞
ﾀﾞﾌﾞﾙﾌﾞﾘｯｼﾞ	ダブルブリッジ	名詞
ﾀﾞﾌﾞﾙﾏｼﾞｯｸｶｸ	ダブルマジック核	名詞
ﾀﾞｴﾝｷﾞﾝｶﾞ	楕円銀河	名詞
ﾀﾞｴﾝｷﾞﾝｶﾞ	だ円銀河	名詞
ﾀﾞｴﾝﾍﾝｺｳ	だ円偏光	名詞
ﾀﾞｴﾝﾍﾝｺｳ	楕円偏光	名詞
ﾀﾞｴﾝﾌｸｸｯｾﾂ	だ円複屈折	名詞
ﾀﾞｴﾝﾍﾝｺｳﾌｸｸｯｾﾂ	だ円偏光複屈折	名詞
ﾀﾞｴﾝﾌｸｸｯｾﾂ	楕円複屈折	名詞
ﾀﾞｴﾝﾍﾝｺｳﾌｸｸｯｾﾂ	楕円偏光複屈折	名詞
ﾀﾞｴﾝﾍﾝｺｳｹｲ	楕円偏光計	名詞
ﾀﾞｴﾝﾍﾝｺｳｹｲ	だ円偏光計	名詞
ﾀﾞｴﾝﾍﾝﾊﾟ	だ円偏波	名詞
ﾀﾞｴﾝﾍﾝﾊﾟ	楕円偏波	名詞
ﾀﾞｴﾝｼﾝﾄﾞｳ	楕円振動	名詞
ﾀﾞｴﾝｼﾝﾄﾞｳ	だ円振動	名詞
ﾀﾞｹﾞｷﾉﾁｭｳｼﾝ	打撃の中心	名詞
ﾀﾞｲｱﾌﾗﾑ	ダイアフラム	名詞
ﾀﾞｲﾊﾞﾘｵﾝ	ダイバリオン	名詞
ﾀﾞｲﾊﾞｰﾀｰ	ダイバーター	名詞
ﾀﾞｲﾌﾞﾝﾊﾟｲｶﾝｽｳ	大分配関数	名詞
ﾀﾞｲﾋｮｳﾃﾝ	代表点	名詞
ﾀﾞｲｲﾁｵﾝﾊﾟ	第一音波	名詞
ﾀﾞｲｹｲｿｸ	台形則	名詞
ﾀﾞｲｷﾎﾞｼｭｳｾｷｶｲﾛ	大規模集積回路	名詞
ﾀﾞｲﾝ	ダイン	名詞
ﾀﾞｲﾅﾐｯｸｽﾍﾟｸﾄﾙ	ダイナミックスペクトル	名詞
ﾀﾞｲﾅﾐﾄﾛﾝ	ダイナミトロン	名詞
ﾀﾞｲﾅﾓﾘﾛﾝ	ダイナモ理論	名詞
ﾀﾞｲﾆﾋﾞﾘｱﾙｹｲｽｳ	第二ビリアル係数	名詞
ﾀﾞｲﾆｺｳﾁｮｳﾊﾊｯｾｲ	第二高調波発生	名詞
ﾀﾞｲﾆｵﾝﾊﾟ	第二音波	名詞
ﾀﾞｲﾆﾘｮｳｼｶ	第二量子化	名詞
ｻｲﾄﾞﾘｮｳｼｶ	再度量子化	名詞
ﾀﾞｲﾆｼｭｶﾚﾝﾄ	第二種カレント	名詞
ﾀﾞｲﾉｰﾄﾞ	ダイノード	名詞
ﾀﾞｲｵｰﾄﾞ	ﾀﾞｲｵｰﾄﾞ	名詞
ﾀﾞｲｵｰﾄﾞｹﾝﾊﾟ	ダイオード検波	名詞
ﾀﾞｲｵｰﾄﾞﾚｰｻﾞｰ	ダイオードレーザー	名詞
ﾀﾞｲｵﾝ	ダイオン	名詞
ﾀﾞｲﾎﾟｰﾙ	ダイポール	名詞
ﾀﾞｲﾗﾀﾝｼｰ	ダイラタンシー	名詞
ﾀﾞｲﾗﾀﾝﾄﾘｭｳﾄﾞｳ	ダイラタント流動	名詞
ﾀﾞｲｾｲｼﾞｭﾝﾌﾞﾝﾌﾟ	大正準分布	名詞
ﾀﾞｲｾｲｼﾞｭﾝｼｭｳﾀﾞﾝ	大正準集団	名詞
ﾀﾞｲｾﾝﾘｮｳｿｸﾃｲ	大線量測定	名詞
ﾀﾞｲｿﾝｶﾞﾀｷｮｳﾒｲｷ	ダイソン型共鳴器	名詞
ﾀﾞｲｿﾝ	Dyson	人名
ﾀﾞｲｿﾝ	ダイソン	人名
ﾀﾞｲｿﾝﾎｳﾃｲｼｷ	ダイソン方程式	名詞
ﾀﾞｲｿﾝﾚﾅｰﾄﾞﾘｰﾌﾟ	ダイソン・レナード・リープ	人名
ﾀﾞｲｽ	ダイス	名詞
ﾀﾞｲｽｳｸﾞﾝ	代数群	名詞
ﾀﾞｲﾄｳｲﾂﾘﾛﾝ	大統一理論	名詞
ﾀﾞｲﾔｸﾞﾗﾑﾎｳ	ダイヤグラム法	名詞
ﾀﾞｲﾔﾓﾝﾄﾞｶﾞﾀｺｳｿﾞｳ	ダイヤモンド型構造	名詞
ﾀﾞｲﾔﾙｹﾞｰｼﾞ	ダイヤルゲージ	名詞
ﾀﾞｲｼﾞｭﾝｶﾝ	大循環	名詞
ﾀﾞｸﾄｽﾄﾘｰﾐﾝｸﾞ	ダクトストリーミング	名詞
ﾀﾞﾐｰﾛｰﾄﾞ	ダミーロード	名詞
ﾀﾞﾝﾄﾞｳｶﾞｸ	弾道学	名詞
ﾀﾞﾝﾄﾞｳｷｮｸｾﾝ	弾道曲線	名詞
ﾀﾞﾝｸﾞﾘﾝｸﾞﾎﾞﾝﾄﾞ	ダングリングボンド	名詞
ﾀﾞﾆｴﾙﾃﾞﾝﾁ	ダニエル電池	名詞
ﾀﾞﾝﾒﾝｹｲｽｳ	断面係数	名詞
ﾀﾞﾝﾒﾝﾆｼﾞﾓｰﾒﾝﾄ	断面二次モーメント	名詞
ﾀﾞﾝﾒﾝｼｭｳｼｭｸﾘﾂ	断面収縮率	名詞
ﾀﾞﾝﾈﾂｱｯｼｭｸ	断熱圧縮	名詞
ﾀﾞﾝﾈﾂｱｯｼｭｸﾘﾂ	断熱圧縮率	名詞
ﾀﾞﾝﾈﾂﾎﾞｳﾁｮｳ	断熱膨張	名詞
ﾀﾞﾝﾈﾂｹﾞﾝﾘﾂ	断熱減率	名詞
ﾀﾞﾝﾈﾂﾍﾝｶ	断熱変化	名詞
ﾀﾞﾝﾈﾂﾌﾍﾝﾘｮｳ	断熱不変量	名詞
ﾀﾞﾝﾈﾂｶｾﾂ	断熱仮説	名詞
ﾀﾞﾝﾈﾂｶﾃｲ	断熱過程	名詞
ﾀﾞﾝﾈﾂｷﾝｼﾞ	断熱近似	名詞
ﾀﾞﾝﾈﾂﾎﾟﾃﾝｼｬﾙ	断熱ポテンシャル	名詞
ﾎﾟﾃﾝｼｬﾙｷｮｸﾒﾝ	ポテンシャル曲面	名詞
ﾎﾟﾃﾝｼｬﾙｷｮｸｾﾝ	ポテンシャル曲線	名詞
ﾀﾞﾝﾈﾂｾﾝ	断熱線	名詞
ﾀﾞﾝﾈﾂｼｮｳｼﾞ	断熱消磁	名詞
ﾀﾞﾝﾈﾂﾃｲﾘ	断熱定理	名詞
ﾀﾞﾝﾈﾂｼﾞｶﾘﾂ	断熱磁化率	名詞
ﾀﾞﾝﾛｷ	断路器	名詞
ﾀﾞﾝｾｲ	弾性	名詞
ﾀﾞﾝｾｲｱﾝﾃｲ	弾性安定	名詞
ﾀﾞﾝｾｲｱﾂﾘｮｸｹｲ	弾性圧力計	名詞
ﾀﾞﾝｾｲｴﾈﾙｷﾞｰ	弾性エネルギー	名詞
ﾀﾞﾝｾｲｹﾞﾝｶｲ	弾性限界	名詞
ﾀﾞﾝｾｲﾊ	弾性波	名詞
ﾀﾞﾝｾｲﾍﾝｹｲ	弾性変形	名詞
ﾀﾞﾝｾｲﾋﾛｳ	弾性疲労	名詞
ﾀﾞﾝｾｲﾋｽﾃﾘｼｽ	弾性ヒステリシス	名詞
ﾀﾞﾝｾｲﾋｽﾞﾐ	弾性ひずみ	名詞
ﾀﾞﾝｾｲﾌｱﾝﾃｲ	弾性不安定	名詞
ﾀﾞﾝｾｲﾌｱﾝﾃｲｾｲ	弾性不安定性	名詞
ﾀﾞﾝｾｲﾋｮｳﾒﾝﾊｿｼ	弾性表面波素子	名詞
ﾀﾞﾝｾｲｹｲｽｳ	弾性係数	名詞
ﾀﾞﾝｾｲｺﾝﾌﾟﾗｲｱﾝｽ	弾性コンプライアンス	名詞
ﾀﾞﾝｾｲｵｳﾘｮｸ	弾性応力	名詞
ﾀﾞﾝｾｲﾎﾟﾃﾝｼｬﾙ	弾性ポテンシャル	名詞
ﾀﾞﾝｾｲﾘﾂ	弾性率	名詞
ﾀﾞﾝｾｲﾘｮｸ	弾性力	名詞
ﾀﾞﾝｾｲｻﾝﾗﾝ	弾性散乱	名詞
ﾀﾞﾝｾｲｾｲﾘｷｶﾞｸ	弾性静力学	名詞
ﾀﾞﾝｾｲｾﾝ	弾性線	名詞
ﾀﾞﾝｾｲｼﾝﾄﾞｳ	弾性振動	名詞
ﾀﾞﾝｾｲｼｮｳﾄﾂ	弾性衝突	名詞
ﾀﾞﾝｾｲﾀｲ	弾性体	名詞
ﾀﾞﾝｾｲﾃｲｽｳ	弾性定数	名詞
ﾀﾞﾝｾｲﾖｺｳ	弾性余効	名詞
ﾀﾞﾝｿｾｲﾊ	弾塑性波	名詞
ﾀﾞﾝｿｾｲﾍﾝｹｲ	弾塑性変形	名詞
ﾀﾞﾗﾝﾍﾞｰﾙ	ダランベール	人名
ﾀﾞﾗﾝﾍﾞｰﾙ	d'Alembert	人名
ﾀﾞﾗﾝﾍﾞｰﾙﾎｳﾃｲｼｷ	ダランベール方程式	名詞
ﾀﾞﾗﾝﾍﾞｰﾙﾉｹﾞﾝﾘ	ダランベールの原理	名詞
ﾀﾞﾗﾝﾍﾞﾙｼｱﾝ	ダランベルシアン	名詞
ﾀﾞｰﾘﾝﾄﾝｾﾂｿﾞｸ	ダーリントン接続	名詞
ﾀﾞﾘｯﾂﾃﾞﾝｼﾂｲ	ダリッツ電子対	名詞
ﾀﾞﾘｯﾂﾌﾟﾛｯﾄ	ダリッツプロット	名詞
ﾀﾞﾙｼｰﾉﾎｳｿｸ	ダルシーの法則	名詞
ﾀﾞｯｼｭﾂﾊﾊﾞ	脱出幅	名詞
ﾀﾞｯｼｭﾂｿｸﾄﾞ	脱出速度	名詞
ﾀﾞﾂｶﾞｽ	脱ガス	名詞
ﾀﾞﾂﾚｲｷ	脱励起	名詞
ﾀﾞﾂﾘ	脱離	名詞
ﾀﾞﾂﾘｴﾈﾙｷﾞｰ	脱離エネルギー	名詞
ﾀﾞﾂﾘｽﾍﾟｸﾄﾙ	脱離スペクトル	名詞
ﾀﾞｰｳｨﾝｺｳ	ダーウィン項	名詞
ﾃﾞﾊﾞｲ	デバイ	人名
ﾃﾞﾊﾞｲ	Debye	人名
ﾃﾞﾊﾞｲﾊﾝｹｲ	デバイ半径	名詞
ﾃﾞﾊﾞｲﾋｭｯｹﾙﾘﾛﾝ	デバイ・ヒュッケル理論	名詞
ﾃﾞﾊﾞｲｶﾝｽｳ	デバイ関数	名詞
ﾀﾞﾊﾞｲｶﾝﾜ	デバイ緩和	名詞
ﾃﾞﾊﾞｲｷﾝｼﾞ	デバイ近似	名詞
ﾃﾞﾊﾞｲﾓｹｲ	デバイ模型	名詞
ﾃﾞﾊﾞｲﾉﾋﾈﾂｼｷ	デバイの比熱式	名詞
ﾃﾞﾊﾞｲｵﾝﾄﾞ	デバイ温度	名詞
ﾃﾞﾊﾞｲｼｪﾗｰﾘﾝｸﾞ	デバイ・シェラーリング	名詞
ﾃﾞﾊﾞｲT3ﾎｳｿｸ	デバイT3法則	名詞
ﾃﾞﾊﾞｲT3ﾎｳｿｸ	デバイ$T^3$法則	名詞
ﾃﾞﾊﾞｲT3ﾎｳｿｸ	デバイT^3法則	名詞
ﾃﾞﾊﾞｲﾁｮｳ	デバイ長	名詞
ﾃﾞﾊﾞｲﾜﾗｰｲﾝｼ	デバイ・ワラー因子	名詞
ﾃﾞﾊﾞﾝﾁｬｰ	デバンチャー	名詞
ﾃﾞﾋﾞｯｿﾝｶﾞﾏｰ	デビッソン・ガマー	人名
ﾃﾞｲｼﾌﾄ	デイシフト	名詞
ﾃﾞｶｯﾌﾟﾙﾄﾞﾊﾞﾝﾄﾞ	デカップルドバンド	名詞
ﾃﾞｺﾐｯｼｮﾆﾝｸﾞ	デコミッショニング	名詞
ﾃﾞｺﾚｰｼｮﾝ	デコレーション	名詞
ﾃﾞﾏｹｰｼｮﾝｼﾞｭﾝｲ	デマケーション準位	名詞
ﾃﾞﾝｱﾂｹﾞﾝ	電圧源	名詞
ﾃﾞﾝｱﾂｹｲ	電圧計	名詞
ﾃﾞﾝｱﾂｺｳｶ	電圧降下	名詞
ﾃﾞﾝｱﾂﾁｮｳｾｲｷ	電圧調整器	名詞
ﾃﾞﾝｱﾂｿﾞｳﾌｸ	電圧増幅	名詞
ﾃﾞﾝｱﾂｿﾞｳﾌｸﾄﾞ	電圧増幅度	名詞
ﾃﾞﾝﾊﾞ	電場	名詞
ﾃﾞﾝﾊﾞﾍﾞｸﾄﾙ	電場ベクトル	名詞
ﾃﾞﾝﾊﾞﾍﾝﾁｮｳｽﾍﾟｸﾄﾙ	電場変調ｽﾍﾟｸﾄﾙ	名詞
ﾃﾞﾝﾊﾞｰｺｳｶ	デンバー効果	名詞
ﾃﾞﾝﾊﾞｷｮｳﾄﾞ	電場強度	名詞
ﾃﾞﾝﾊﾞﾉﾂﾖｻ	電場の強さ	名詞
ﾃﾞﾝﾄﾞｳ	伝導	名詞
ﾃﾞﾝﾄﾞｳﾃﾞﾝﾘｭｳ	伝導電流	名詞
ﾃﾞﾝﾄﾞｳﾃﾞﾝｼ	伝導電子	名詞
ﾃﾞﾝﾄﾞｳﾄﾞ	伝導度	名詞
ﾃﾞﾝﾄﾞｳﾊﾂﾃﾞﾝｷ	電動発電機	名詞
ﾃﾞﾝﾄﾞｳｷ	電動機	名詞
ﾃﾞﾝﾄﾞｳﾘﾂ	伝導率	名詞
ﾃﾞﾝﾄﾞｳﾀｲ	伝導帯	名詞
ﾃﾞﾝｲｹｲ	電位計	名詞
ﾃﾞﾝｲｹｲｽｳ	電位係数	名詞
ﾃﾞﾝｲｻｹｲ	電位差計	名詞
ﾃﾞﾝｲｻﾃｷﾃｲ	電位差滴定	名詞
ﾃﾞﾝｶﾌﾞﾝﾌﾟ	電荷分布	名詞
ﾃﾞﾝｶﾎｿﾞﾝｿｸ	電荷保存則	名詞
ﾃﾞﾝｶｲﾃﾞﾝｼﾎｳｼｭﾂ	電界電子放出	名詞
ﾃﾞﾝｶｲﾃﾞﾝｼｹﾝﾋﾞｷｮｳ	電界電子顕微鏡	名詞
ﾃﾞﾝｶｲﾄﾞｳ	電荷移動	名詞
ﾃﾞﾝｶｲﾄﾞｳｻｸﾀｲ	電荷移動錯体	名詞
ﾃﾞﾝｶｲﾄﾞｳｽﾍﾟｸﾄﾙ	電荷移動スペクトル	名詞
ﾃﾞﾝｶｲﾄﾞｳｼﾞｭｳｺﾞｳ	電荷移動重合	名詞
ﾃﾞﾝｶｲﾌｨﾗﾒﾝﾄ	電界フィラメント	名詞
ﾃﾞﾝｶｲｶﾞﾀﾊﾝﾄﾞｳﾀｲ	電解型半導体	名詞
ﾃﾞﾝｶｲﾊｯｺｳ	電界発光	名詞
ﾃﾞﾝｶｲﾎｳｼｭﾂ	電界放出	名詞
ﾃﾞﾝｶｲﾎｳｼｭﾂﾃﾞﾝｼ	電界放出電子	名詞
ﾃﾞﾝｶｲｲｵﾝｹﾝﾋﾞｷｮｳ	電界イオン顕微鏡	名詞
ﾃﾞﾝｶｲｹﾝﾏ	電解研磨	名詞
ﾃﾞﾝｶｲｺｳ	電荷移行	名詞
ﾃﾞﾝｶｲｺｳｶﾄﾗﾝｼﾞｽﾀｰ	電界効果トランジスター	名詞
ﾃﾞﾝｶｲｺﾝﾃﾞﾝｻｰ	電解コンデンサー	名詞
ﾃﾞﾝｶｲｷｮｳﾄﾞ	電界強度	名詞
ﾃﾞﾝｶｲﾚﾝｽﾞ	電界レンズ	名詞
ﾃﾞﾝｶｲｿｳ	電解槽	名詞
ﾃﾞﾝｶｲｼｭｳｿｸ	電界集束	名詞
ﾃﾞﾝｶｲｼﾞｮｳﾊﾂ	電界蒸発	名詞
ﾃﾞﾝｶｲｼﾞｭｳｺﾞｳ	電解重合	名詞
ﾃﾞﾝｶｹﾂｺﾞｳｿｼ	電荷結合素子	名詞
ﾃﾞﾝｶﾐﾂﾄﾞ	電荷密度	名詞
ﾃﾞﾝｶﾐﾂﾄﾞﾊ	電荷密度波	名詞
ﾃﾞﾝｶﾃﾝｿｳｿｼ	電荷転送素子	名詞
ﾃﾞﾝｷﾌﾞﾝｶｲ	電気分解	名詞
ﾃﾞﾝｷﾃﾞﾝﾄﾞｳ	電気伝導	名詞
ﾃﾞﾝｷﾃﾞﾝﾄﾞｳﾘﾂ	電気伝導率	名詞
ﾃﾞﾝｷｴｲﾄﾞｳ	電気泳動	名詞
ﾃﾞﾝｷｴｲｿﾞｳ	電気映像	名詞
ﾃﾞﾝｷｴﾈﾙｷﾞｰ	電気エネルギー	名詞
ﾃﾞﾝｷｶﾞｸ	電気学	名詞
ﾃﾞﾝｷﾍﾝｲ	電気変位	名詞
ﾃﾞﾝｷﾋｽﾞﾐ	電気ひずみ	名詞
ﾃﾞﾝｷﾌｸｸｯｾﾂ	電気複屈折	名詞
ﾃﾞﾝｷﾌﾘｺ	電気振り子	名詞
ﾃﾞﾝｷｲﾝｾｲﾄﾞ	電気陰性度	名詞
ﾃﾞﾝｷｶｶﾞｸﾌﾞﾝｾｷ	電気化学分析	名詞
ﾃﾞﾝｷｶｶﾞｸﾄｳﾘｮｳ	電気化学当量	名詞
ﾃﾞﾝｷｶｶﾞｸﾎﾟﾃﾝｼｬﾙ	電気化学ポテンシャル	名詞
ﾃﾞﾝｷｶｲﾛ	電気回路	名詞
ﾃﾞﾝｷｶﾝｼﾞｭﾘﾂ	電気感受率	名詞
ﾃﾞﾝｷｷｶｲｵﾝｷｮｳﾙｲｼﾞ	電気機械音響類似	名詞
ﾃﾞﾝｷｺｳｶﾞｸｺｳｶ	電気光学効果	名詞
ﾃﾞﾝｷｷｮｳｼﾝ	電気共振	名詞
ﾃﾞﾝｷﾓｳｶﾝｹﾞﾝｼｮｳ	電気毛管現象	名詞
ﾓｳｶﾝﾃﾞﾝｷｹﾞﾝｼｮｳ	毛管電気現象	名詞
ﾃﾞﾝｷﾈﾂﾘｮｳｹｲ	電気熱量計	名詞
ﾃﾞﾝｷﾆｼﾞｭｳｿｳ	電気二重層	名詞
ﾃﾞﾝｷｵﾝｷｮｳｶﾞｸ	電気音響学	名詞
ﾃﾞﾝｷｵﾝｷｮｳﾍﾝｶﾝｷ	電気音響変換器	名詞
ﾃﾞﾝｷﾘｷｶﾞｸ	電気力学	名詞
ﾃﾞﾝｷﾘｷｶﾞｸﾃｷｻﾖｳ	電気力学的作用	名詞
ﾃﾞﾝｷﾘｷｾﾝ	電気力線	名詞
ﾃﾞﾝｷﾘｮｳ	電気量	名詞
ﾃﾞﾝｷﾘｮｸ	電気力	名詞
ﾃﾞﾝｷﾘｮｸｶﾝ	電気力管	名詞
ﾃﾞﾝｷﾘｭｳﾀｲﾙｲｼﾞ	電気流体類似	名詞
ﾃﾞﾝｷｾｷ	電気石	名詞
ﾃﾞﾝｷｼ	電機子	名詞
ﾃﾞﾝｷｼｷｮｸﾓｰﾒﾝﾄ	電気四極モーメント	名詞
ﾃﾞﾝｷｼｷｮｸｼ	電気四極子	名詞
ﾃﾞﾝｷｼﾝﾄﾞｳ	電気振動	名詞
ﾃﾞﾝｷｼﾝﾄｳ	電気浸透	名詞
ﾃﾞﾝｷｿｳｷｮｸｼ	電気双極子	名詞
ﾃﾞﾝｷｿｳｷｮｸｼﾓｰﾒﾝﾄ	電気双極子モーメント	名詞
ﾃﾞﾝｷｿｳｷｮｸﾓｰﾒﾝﾄ	電気双極モーメント	名詞
ﾃﾞﾝｷｿﾘｮｳ	電気素量	名詞
ﾃﾞﾝｷﾀｷｮｸｼ	電気多極子	名詞
ﾃﾞﾝｷﾀﾝｷｮｸｼ	電気単極子	名詞
ﾃﾞﾝｷﾃｲｺｳ	電気抵抗	名詞
ﾃﾞﾝｷﾃｲｺｳｷｮｸｼｮｳ	電気抵抗極小	名詞
ﾃﾞﾝｷﾃｲｺｳﾘﾂ	電気抵抗率	名詞
ﾃﾞﾝｷﾃｷﾌﾞﾝｷｮｸﾘﾂ	電気的分極率	名詞
ﾃﾞﾝｷﾃﾝﾋﾞﾝ	電気てんびん	名詞
ﾃﾞﾝｷﾖｳﾘｮｳ	電気容量	名詞
ﾃﾞﾝｷｼﾞｷｺｳｶ	電気磁気効果	名詞
ﾃﾞﾝｷｮｸﾃﾞﾝｲ	電極電位	名詞
ﾃﾞﾝﾈﾂ	伝熱	名詞
ﾃﾞﾝﾈﾂﾊﾞｲﾀｲ	伝熱媒体	名詞
ﾃﾞﾝﾊﾟｱﾝｼﾂ	電波暗室	名詞
ﾃﾞﾝﾊﾟﾎﾞｳｴﾝｷｮｳ	電波望遠鏡	名詞
ﾃﾞﾝﾊﾟﾌﾞﾝｺｳｶﾞｸ	電波分光学	名詞
ﾃﾞﾝﾊﾟﾃﾞﾝﾊﾟﾝ	電波伝搬	名詞
ﾃﾞﾝﾊﾟｹﾞﾝ	電波源	名詞
ﾃﾞﾝﾊﾟｷﾞﾝｶﾞ	電波銀河	名詞
ﾃﾞﾝﾊﾟｶﾝｼｮｳｹｲ	電波干渉計	名詞
ﾃﾞﾝﾊﾟｷｭｳｼｭｳﾀｲ	電波吸収体	名詞
ﾃﾞﾝﾊﾟﾝﾍﾞｸﾄﾙ	伝搬ベクトル	名詞
ﾃﾞﾝﾊﾟﾝｶﾝｽｳ	伝搬関数	名詞
ﾃﾞﾝﾊﾟｾｲ	電波星	名詞
ﾃﾞﾝﾊﾟｽﾍﾟｸﾄﾙ	電波スペクトル	名詞
ﾃﾞﾝﾊﾟﾃﾝﾓﾝｶﾞｸ	電波天文学	名詞
ﾃﾞﾝﾊﾟｻﾞﾂｵﾝ	電波雑音	名詞
ﾃﾞﾝﾘﾊﾞｺ	電離箱	名詞
ﾃﾞﾝﾘﾄﾞ	電離度	名詞
ｲｵﾝｶｴﾈﾙｷﾞｰ	イオン化エネルギー	名詞
ﾃﾞﾝﾘﾍｲｺｳ	電離平衡	名詞
ﾃﾞﾝﾘｹｲｽｳ	電離係数	名詞
ﾃﾞﾝﾘｹﾝ	電離圏	名詞
ﾃﾞﾝﾘｷﾀｲ	電離気体	名詞
ﾃﾞﾝﾘｺｳﾘﾂ	電離効率	名詞
ｲｵﾝｶｺｳﾘﾂ	イオン化効率	名詞
ﾃﾞﾝﾘｼﾝｸｳｹｲ	電離真空計	名詞
ﾃﾞﾝﾘｿｳ	電離層	名詞
ﾃﾞﾝﾘﾖｳﾄﾞｳ	電離揺動	名詞
ﾃﾞﾝﾘﾕﾗｷﾞ	電離ゆらぎ	名詞
ﾃﾞﾝﾘｮｸﾘｮｳｹｲ	電力量計	名詞
ｾｷｻﾝﾃﾞﾝﾘｮｸｹｲ	積算電力計	名詞
ﾃﾞﾝﾘｭｳｹﾞﾝ	電流源	名詞
ﾃﾞﾝﾘｭｳｷﾘｶｴｶｲﾛ	電流切換回路	名詞
ﾃﾞﾝﾘｭｳﾃﾝﾋﾞﾝ	電流てんびん	名詞
ﾃﾞﾝﾘｭｳｼﾞｷｺｳｶ	電流磁気効果	名詞
ﾃﾞﾝﾘｭｳｿﾞｳﾌｸﾘﾂ	電流増幅率	名詞
ﾃﾞﾝｼﾊﾞﾝﾄﾞｽﾍﾟｸﾄﾙ	電子バンドスペクトル	名詞
ﾃﾞﾝｼﾀｲｽﾍﾟｸﾄﾙ	電子帯スペクトル	名詞
ﾃﾞﾝｼﾋﾞｰﾑ	電子ビーム	名詞
ﾃﾞﾝｼﾋﾞｰﾑｶｺｳ	電子ビーム加工	名詞
ﾃﾞﾝｼﾋﾞｰﾑﾚｲｷﾚｰｻﾞｰ	電子ビーム励起レーザー	名詞
ｾｲｷﾞｮﾎｳﾃﾞﾝ	制御放電	名詞
ﾃﾞﾝｼﾎﾞﾙﾄ	電子ボルト	名詞
ﾃﾞﾝｼﾌﾞﾝｺｳﾎｳ	電子分光法	名詞
ﾃﾞﾝｼﾌﾞﾝｷｮｸ	電子分極	名詞
ﾃﾞﾝｼﾀﾞﾂﾘ	電子脱離	名詞
ｿﾝｼﾂﾌﾞﾝｺｳ	損失分光	名詞
ｿﾝｼﾂﾌﾞﾝｺｳﾎｳ	損失分光法	名詞
ﾃﾞﾝｼﾌｫﾉﾝｹｲ	電子-フォノン系	名詞
ﾃﾞﾝｼﾌｫﾉﾝｿｳｺﾞｻﾖｳ	電子-フォノン相互作用	名詞
ﾃﾞﾝｼｶﾞｽ	電子ガス	名詞
ﾃﾞﾝｼｹﾞﾝ	電子源	名詞
ﾃﾞﾝｼﾊ	電子波	名詞
ﾃﾞﾝｼﾊｲﾁ	電子配置	名詞
ﾃﾞﾝｼﾋﾈﾂ	電子比熱	名詞
ﾃﾞﾝｼﾎｶｸ	電子捕獲	名詞
ﾃﾞﾝｼﾎｳｼｭﾂ	電子放出	名詞
ﾃﾞﾝｼﾎｳﾜﾃﾞﾝﾘｭｳ	電子飽和電流	名詞
ﾃﾞﾝｼﾌﾁｬｸ	電子付着	名詞
ﾃﾞﾝｼｲﾄﾞｳ	電子移動	名詞
ﾃﾞﾝｼｲﾄﾞｳﾄﾞ	電子移動度	名詞
ﾃﾞﾝｼｲｺｳ	電子移行	名詞
ﾃﾞﾝｼｶｲｾﾂ	電子回折	名詞
ﾃﾞﾝｼｶｸ	電子殻	名詞
ﾃﾞﾝｼｶｸﾆｼﾞｭｳｷｮｳﾒｲ	電子-核二重共鳴	名詞
ﾃﾞﾝｼｶﾝ	電子管	名詞
ﾃﾞﾝｼｹﾝﾋﾞｷｮｳ	電子顕微鏡	名詞
ﾃﾞﾝｼｺｳ	電子項	名詞
ﾃﾞﾝｼｾﾝｲ	電子遷移	名詞
ﾃﾞﾝｼｺｳｾﾝｲ	電子項遷移	名詞
ﾃﾞﾝｼｺｳｼｿｳｺﾞｻﾖｳ	電子-格子相互作用	名詞
ﾃﾞﾝｼｺｳｿﾞｳ	電子構造	名詞
ﾃﾞﾝｼｷｮｳﾖﾀｲ	電子供与体	名詞
ﾃﾞﾝｼﾏｲｸﾛﾌﾟﾛｰﾌﾞ	電子マイクロプローブ	名詞
ﾃﾞﾝｼﾐﾂﾄﾞ	電子密度	名詞
ﾃﾞﾝｼﾅﾀﾞﾚ	電子雪崩	名詞
ﾃﾞﾝｼﾅﾀﾞﾚｺｳｶ	電子雪崩効果	名詞
ﾅﾀﾞﾚｺｳｶ	雪崩効果	名詞
ﾃﾞﾝｼﾝﾎｳﾃｲｼｷ	電信方程式	名詞
ﾃﾞﾝｼﾉﾗｰﾓｱﾊﾝｹｲ	電子のラーモア半径	名詞
ﾃﾞﾝｼﾆｭｰﾄﾘﾉ	電子ニュートリノ	名詞
ﾃﾞﾝｼｵﾝﾄﾞ	電子温度	名詞
ﾃﾞﾝｼﾌﾟﾗｽﾞﾏﾊ	電子プラズマ波	名詞
ﾌﾟﾗｽﾞﾏｼﾝﾄﾞｳｽｳ	プラズマ振動数	名詞
ﾃﾞﾝｼﾚｲｷ	電子励起	名詞
ﾃﾞﾝｼﾚｲｷｬｸ	電子冷却	名詞
ﾃﾞﾝｼﾚｲｷｬｸｿｼ	電子冷却素子	名詞
ﾃﾞﾝｼﾚﾝｽﾞ	電子レンズ	名詞
ﾃﾞﾝｼﾘﾝｸﾞｶｿｸｷ	電子リング加速器	名詞
ﾃﾞﾝｼﾛﾝ	電子論	名詞
ｻｲｸﾛﾄﾛﾝｷｮｳﾒｲｶﾈﾂ	サイクロトロン共鳴加熱	名詞
ﾃﾞﾝｼｾｲｺｳｴｷﾃｷ	電子-正孔液滴	名詞
ﾃﾞﾝｼｾｲｺｳﾂｲ	電子正孔対	名詞
ﾃﾞﾝｼｾﾝ	電子線	名詞
ﾃﾞﾝｼｾﾝﾎﾛｸﾞﾗﾌｨｰ	電子線ホログラフィー	名詞
ﾃﾞﾝｼｾﾝｶｲｾﾂ	電子線回折	名詞
ﾃﾞﾝｼｾﾝｶﾝｼｮｳｹｲ	電子線干渉計	名詞
ﾃﾞﾝｼｾﾝﾉｷｮｳﾄﾞｹｲｿｸ	電子線の強度計測	名詞
ﾃﾞﾝｼｾﾝｽﾍﾟｸﾄﾛﾒｰﾀｰ	電子線スペクトロメーター	名詞
ﾃﾞﾝｼｾﾝﾁｬﾈﾘﾝｸﾞ	電子線チャネリング	名詞
ﾃﾞﾝｼｼｹﾞｷﾀﾞﾂﾘ	電子刺激脱離	名詞
ﾃﾞﾝｼｼﾝﾜﾘｮｸ	電子親和力	名詞
ﾃﾞﾝｼｿｳｶﾝ	電子相関	名詞
ﾃﾞﾝｼｿｳｺｳｲﾝｼ	電子走行因子	名詞
ﾃﾞﾝｼｽｲｯﾁ	電子スイッチ	名詞
ﾃﾞﾝｼｽﾍﾟｸﾄﾙ	電子スペクトル	名詞
ﾃﾞﾝｼｽﾋﾟﾝｶﾝﾜ	電子スピン緩和	名詞
ﾃﾞﾝｼｽﾋﾟﾝｷｮｳﾒｲ	電子スピン共鳴	名詞
ｽﾋﾟﾝﾆｼﾞｭｳｷｮｳﾒｲ	スピン二重共鳴	名詞
ﾃﾞﾝｼｼｮｳｹﾞｷ	電子衝撃	名詞
ｼｮｳｹﾞｷﾌﾞﾝｺｳﾎｳ	衝撃分光法	名詞
ﾃﾞﾝｼｼｮｳｹﾞｷﾀﾞﾂﾘ	電子衝撃脱離	名詞
ﾃﾞﾝｼｼｮｳｲ	電子昇位	名詞
ﾃﾞﾝｼﾃｷｿｼﾉｳ	電子的阻止能	名詞
ﾃﾞﾝｼﾄﾝﾈﾙﾌﾞﾝｺｳ	電子トンネル分光	名詞
ﾃﾞﾝｼﾄﾗｯﾌﾟ	電子トラップ	名詞
ﾃﾞﾝｼﾄﾗｯﾌﾟﾎｳ	電子トラップ法	名詞
ﾃﾞﾝｼﾂｲ	電子対	名詞
ﾃﾞﾝｼﾖｳﾃﾞﾝｼｼｮｳﾄﾂ	電子-陽電子衝突	名詞
ﾃﾞﾝｼﾖｳﾃﾞﾝｼﾂｲｾｲｾｲ	電子-陽電子対生成	名詞
ﾖｳﾃﾞﾝｼﾂｲｼｮｳﾒﾂ	-陽電子対消滅	名詞
ﾃﾞﾝｼｿﾞｸｽｳ	電子族数	名詞
ﾃﾞﾝｼｼﾞｮｳﾀｲ	電子状態	名詞
ﾃﾞﾝｼｼﾞｭｳ	電子銃	名詞
ﾃﾞﾝｼｼﾞｭﾖｳﾀｲ	電子受容体	名詞
ﾃﾞﾝｿｳｷﾞｮｳﾚﾂ	伝送行列	名詞
ﾃﾞﾝｿｸ	電束	名詞
ﾃﾞﾝｿｸﾃﾞﾝﾘｭｳ	電束電流	名詞
ﾃﾞﾝｿｸｶﾝ	電束管	名詞
ﾃﾞﾝｿｸﾐﾂﾄﾞ	電束密度	名詞
ﾃﾞﾝｿｳｾｷﾌﾞﾝﾉﾎｳﾎｳ	伝送積分の方法	名詞
ﾃﾞﾝｿｳｾﾝ	伝送線	名詞
ﾃﾞﾝﾀﾂｶﾝｽｳ	伝達関数	名詞
ﾃﾞﾝｼﾞﾊﾞ	電磁場	名詞
ﾃﾞﾝｼﾞﾊﾞﾉｳﾝﾄﾞｳﾘｮｳ	電磁場の運動量	名詞
ﾃﾞﾝｼﾞﾍﾞﾝ	電磁弁	名詞
ﾃﾞﾝｼﾞﾊ	電磁波	名詞
ﾃﾞﾝｼﾞﾎｰﾝ	電磁ホーン	名詞
ﾃﾞﾝｼﾞﾎｳｼｬ	電磁放射	名詞
ﾃﾞﾝｼﾞｶｲ	電磁界	名詞
ﾃﾞﾝｼﾞｶｽｹｰﾄﾞｼｬﾜｰ	電磁カスケードシャワー	名詞
ﾃﾞﾝｼﾞｹｲｼﾞｮｳｲﾝｼ	電磁形状因子	名詞
ﾃﾞﾝｼﾞｷｶﾞｸ	電磁気学	名詞
ﾃﾞﾝｼﾞﾘｮｸ	電磁力	名詞
ﾃﾞﾝｼﾞｷﾘｮｸ	電磁気力	名詞
ﾃﾞﾝｼﾞｷﾃｷｼﾂﾘｮｳｻ	電磁気的質量差	名詞
ﾃﾞﾝｼﾞｺｳｶﾞｸ	電磁光学	名詞
ﾃﾞﾝｼﾞｵｼﾛｸﾞﾗﾌ	電磁オシログラフ	名詞
ﾃﾞﾝｼﾞﾎﾟﾃﾝｼｬﾙ	電磁ポテンシャル	名詞
ﾃﾞﾝｼﾞﾘｭｳﾘｮｳｹｲ	電磁流量計	名詞
ﾃﾞﾝｼﾞﾘｭｳﾀｲ	電磁流体	名詞
ﾃﾞﾝｼﾞﾘｭｳﾀｲﾊﾂﾃﾞﾝ	電磁流体発電	名詞
MHﾃﾞｬﾂﾃﾞﾝ	MHD発電	名詞
ﾃﾞﾝｼﾞﾘｭｳﾀｲﾘｷｶﾞｸ	電磁流体力学	名詞
ﾘｷｶﾞｸﾃｷﾌｱﾝﾃｲｾｲ	力学的不安定性	名詞
ﾃﾞﾝｼﾞｾﾝｲ	電磁遷移	名詞
ﾃﾞﾝｼﾞｼﾂﾘｮｳ	電磁質量	名詞
ﾃﾞﾝｼﾞｿｳｺﾞｻﾖｳ	電磁相互作用	名詞
ﾃﾞﾝｼﾞｼｬﾀﾞﾝ	電磁遮断	名詞
ﾃﾞﾝｼﾞﾀｷｮｸｼﾓｰﾒﾝﾄ	電磁多極子モーメント	名詞
ﾃﾞﾝｼﾞﾀﾝｲｹｲ	電磁単位系	名詞
ﾃﾞﾝｼﾞﾕｳﾄﾞｳ	電磁誘導	名詞
ﾃﾞﾝｼﾞｬｸﾘﾛﾝ	電弱理論	名詞
ﾃﾞﾝｼﾞｬｸｿｳｺﾞｻﾖｳ	電弱相互作用	名詞
ﾃﾞｵｷｼﾘﾎﾞｶｸｻﾝ	デオキシリボ核酸	名詞
ﾃﾞﾗﾝﾄﾞﾙﾋｮｳ	デランドル表	名詞
ﾃﾞﾘﾝｼﾞｬｰｹﾞﾝｼｮｳ	デリンジャー現象	名詞
ﾃﾞﾙﾌﾞﾘｭｯｸｻﾝﾗﾝ	デルブリュック散乱	名詞
ﾃﾞｰﾀﾂｳｼﾝ	データ通信	名詞
ﾃﾞﾄﾈｰｼｮﾝ	デトネーション	名詞
ﾃﾞｨﾌｪｸﾄﾝ	ディフェクトン	名詞
ﾃﾞｨｰ	ディー	名詞
ﾃﾞｨｰｾﾞﾙｻｲｸﾙ	ディーゼルサイクル	名詞
ﾃﾞｨﾝｸﾞﾙｵﾝﾄﾞ	ディングル温度	名詞
ﾃﾞｨｵﾌﾟﾄﾘｰ	ディオプトリー	名詞
ﾃﾞｨﾗｯｸ	ディラック	人名
ﾃﾞｨﾗｯｸ	Dirac	人名
ﾃﾞｨﾗｯｸﾃﾞﾝｼﾛﾝ	ディラック電子論	名詞
ﾃﾞｨﾗｯｸﾎｳﾃｲｼｷ	ディラック方程式	名詞
ﾃﾞｨﾗｯｸｶｯｺ	ディラック括弧	名詞
ﾃﾞｨﾗｯｸﾓｰﾒﾝﾄ	ディラクモーメント	名詞
ﾃﾞｨﾗｯｸﾉﾘｮｳｼｶ	ディラックの量子化	名詞
ﾃﾞｨﾗｯｸﾘｭｳｼ	ディラック粒子	名詞
ﾃﾞｨﾗｯｸｽﾋﾟﾉﾙ	ディラックスピノル	名詞
ﾃﾞｨﾗﾃｰｼｮﾝ	ディラテーション	名詞
ﾃﾞｨﾗﾄﾒﾄﾘｰ	ディラトメトリー	名詞
ﾃﾞｨﾘｸﾚｷｭｳｽｳ	ディリクレ級数	名詞
ﾃﾞｨｽｺﾒﾝｼｭﾚｰｼｮﾝ	ディスコメンシュレーション	名詞
ﾃﾞｨｽｸﾚｰｻﾞｰ	ディスクレーザー	名詞
ﾃﾞｨﾁｬﾈﾘﾝｸﾞ	ディチャネリング	名詞
ﾃﾞｨｼﾞﾀｲｻﾞｰ	ディジタイザー	名詞
ﾃﾞｨｼﾞﾀﾙﾃﾞﾝｱﾂｹｲ	ディジタル電圧計	名詞
ﾃﾞｨｼﾞﾀﾙｶｲﾛ	ディジタル回路	名詞
ﾃﾞｨｼﾞﾀﾙｼﾝｺﾞｳ	ディジタル信号	名詞
ﾄﾞｳｱﾂ	動圧	名詞
ﾄﾞｳｱﾂﾘｮｸ	動圧力	名詞
ﾄﾞｰﾌﾞﾌﾟﾘｽﾞﾑ	ドーブプリズム	名詞
ﾄﾞﾌﾞﾛｲ	ドブロイ	人名
ﾄﾞﾌﾞﾛｲ	deBroglie	人名
ﾄﾞﾌﾞﾛｲﾊ	ドブロイ波	名詞
ﾄﾞﾌﾞﾛｲﾊﾁｮｳ	ドブロイ波長	名詞
ﾄﾞﾌﾞﾛｲﾉｼｷ	ドブロイの式	名詞
ﾄﾞﾌﾞﾛｲﾉｶﾝｹｲｼｷ	ドブロイの関係式	名詞
ﾄﾞｳﾃﾞﾝｾｲﾘｭｳﾀｲ	導電性流体	名詞
ﾄﾞｳﾊｶﾝ	導波管	名詞
ﾄﾞｳﾊﾓｰﾄﾞ	導波モード	名詞
ﾄﾞｳﾊﾛﾚｰｻﾞｰ	導波路レーザー	名詞
ﾄﾞﾊｰｽﾌｧﾝｱﾙﾌｪﾝｺｳｶ	ドハース・ファンアルフェン効果	名詞
ﾄﾞｳﾋ	銅比	名詞
ﾄﾞｳｲｹﾞﾝｿ	同位元素	名詞
ﾄﾞｳｲｶｸ	同位核	名詞
ﾄﾞｳｲﾀｲ	同位体	名詞
ﾄﾞｳｲﾀｲﾌﾞﾝﾘ	同位体分離	名詞
ﾄﾞｳｲﾀｲﾌﾞﾝﾘｿｳﾁ	同位体分離装置	名詞
ﾄﾞｳｲﾀｲﾌﾞﾝｾｷ	同位体分析	名詞
ﾄﾞｳｲﾀｲﾍﾝｲ	同位体偏移	名詞
ﾄﾞｳｲﾀｲﾋｶﾝｼｮｳｾｲ	同位体非干渉性	名詞
ﾄﾞｳｲﾀｲｺｳｶ	同位体効果	名詞
ﾄﾞｳｲﾀｲｼﾌﾄ	同位体シフト	名詞
ﾄﾞｳｲﾀｲｿﾝｻﾞｲﾄﾞ	同位体存在度	名詞
ﾄﾞｳｶｼﾞｭｳ	動荷重	名詞
ﾄﾞｳｹｲ	動径	名詞
ﾄﾞｳｹｲﾍﾞｸﾄﾙ	動径ベクトル	名詞
ﾄﾞｳｹｲﾌﾞﾝﾌﾟｶﾝｽｳ	動径分布関数	名詞
ﾄﾞｳｹｲｶｿｸﾄﾞ	動径加速度	名詞
ﾄﾞｳｹｲｹﾂｺﾞｳ	動径結合	名詞
ﾄﾞｳｹｲﾏｳﾝﾃｨﾝｸﾞ	動径マウンティング	名詞
ﾄﾞｳｹｲﾘｮｳｼｽｳ	動径量子数	名詞
ﾄﾞｳｹｲｿｸﾄﾞ	動径速度	名詞
ﾄﾞｳｹｲﾁｶﾝﾎｳ	同型置換法	名詞
ﾄﾞｳｷ	同期	名詞
ﾄﾞｳｷｶ	同期化	名詞
ﾄﾞｳｷｹﾝﾊﾟ	同期検波	名詞
ﾄﾞｳｷｾｲﾘｭｳ	同期整流	名詞
ﾄﾞｳｺﾝｽﾀﾝﾀﾝ	銅-コンスタンタン	名詞
ﾄﾞｸﾘﾂｹﾞﾝｼﾓｹｲ	独立原子模型	名詞
ﾄﾞｸﾘﾂﾘｭｳｼﾓｹｲ	独立粒子模型	名詞
ﾄﾞｸﾘﾂﾘｭｳｼﾂｲﾓｹｲ	独立粒子対模型	名詞
ﾄﾞｸﾘﾂｻﾖｳﾉﾎｳｿｸ	独立作用の法則	名詞
ﾄﾞｳﾏｻﾂ	動摩擦	名詞
ｳﾝﾄﾞｳﾏｻﾂ	運動摩擦	名詞
ﾄﾞｳﾏｻﾂｹｲｽｳ	動摩擦係数	名詞
ｳﾝﾄﾞｳﾏｻﾂｹｲｽｳ	運動摩擦係数	名詞
ﾄﾞﾅｰ	ドナー	名詞
ｱｸｾﾌﾟﾀｰﾂｲﾊｯｺｳ	-アクセプター対発光	名詞
ﾄﾞﾅｰｼﾞｭﾝｲ	ドナー準位	名詞
ﾄﾞｳﾈﾝｾｲﾘﾂ	動粘性率	名詞
ｳﾝﾄﾞｳﾈﾝｾｲﾘﾂ	運動粘性率	名詞
ﾄﾞｳﾈﾂﾘｮｳｹｲ	銅熱量計	名詞
ﾄﾞﾝｹｲﾚﾂ	鈍系列	名詞
ﾄﾞｰﾋﾟﾝｸﾞ	ドーピング	名詞
ﾄﾞｯﾌﾟﾗｰ	ドップラー	人名
ﾄﾞｯﾌﾟﾗｰ	Doppler	人名
ﾄﾞｯﾌﾟﾗｰﾊﾊﾞ	ドップラー幅	名詞
ﾄﾞｯﾌﾟﾗｰﾋﾛｶﾞﾘ	ドップラー広がり	名詞
ﾄﾞｯﾌﾟﾗｰﾌﾘｰ	ドップラーフリー	名詞
ﾄﾞｯﾌﾟﾗｰｺｳｶ	ドップラー効果	名詞
ﾄﾞｯﾌﾟﾗｰｼﾌﾄ	ドップラーシフト	名詞
ﾄﾞﾗｯｸﾞｺｳｶ	ドラッグ効果	名詞
ﾄﾞﾚｲﾝ	ドレイン	名詞
ﾄﾞﾚﾙﾋ	ドレル比	名詞
ﾄﾞﾘﾌﾄﾃﾞﾝﾘｭｳ	ドリフト電流	名詞
ﾄﾞﾘﾌﾄｶﾞﾀﾄﾗﾝｼﾞｽﾀｰ	ドリフト型トランジスター	名詞
ﾄﾞﾘﾌﾄﾊ	ドリフト波	名詞
ﾄﾞﾘﾌﾄﾌｱﾝﾃｲｾｲ	ドリフト不安定性	名詞
ﾄﾞﾘﾌﾄｲﾄﾞｳﾄﾞ	ドリフト移動度	名詞
ﾄﾞﾘﾌﾄｷﾝｼﾞ	ドリフト近似	名詞
ﾄﾞﾘﾌﾄﾉｺｳ	ドリフトの項	名詞
ﾄﾞﾘﾌﾄｿｸﾄﾞ	ドリフト速度	名詞
ﾄﾞﾘﾌﾄﾁｪﾝﾊﾞｰ	ドリフトチェンバー	名詞
ﾄﾞﾘﾌﾄﾁｭｰﾌﾞ	ドリフトチューブ	名詞
ﾄﾞｳﾘｷｶﾞｸ	動力学	名詞
ﾄﾞｰﾘﾄﾙﾉﾈﾝﾄﾞｼｷ	ドーリトルの粘度式	名詞
ﾄﾞﾙｰﾃﾞﾉﾘﾛﾝ	ドルーデの理論	名詞
ﾄﾞﾙｰﾃﾞﾉｼｷ	ドルーデの式	名詞
ﾄﾞﾙﾄﾝﾉﾎｳｿｸ	ドルトンの法則	名詞
ﾄﾞﾙﾄﾝﾉﾌﾞﾝｱﾂﾉﾎｳｿｸ	ドルトンの分圧の法則	名詞
ﾄﾞﾘｮｳｺｳ	度量衡	名詞
ﾄﾞｳﾘｮｸｹｲ	動力計	名詞
ﾄﾞｳｾﾝ	導線	名詞
ﾄﾞｳｿﾀｲ	同素体	名詞
ﾄﾞｽｳｹｲ	度数計	名詞
ﾄﾞｳｼｭﾘｭｳｼ	同種粒子	名詞
ﾌｶﾍﾞﾝﾍﾞﾂｾｲ	不可弁別性	名詞
ﾄﾞｳｼｭｾﾂﾄﾞｳ	同種摂動	名詞
ﾄﾞｳﾀｲｷｭｳ	導体球	名詞
ﾄﾞｳﾃｷｱﾝﾃｲｶ	動的安定化	名詞
ﾄﾞｳﾃｷﾌﾞﾝｷｮｸﾘﾂ	動的分極率	名詞
ﾄﾞｳﾃｷｶｼﾞｭｳ	動的荷重	名詞
ﾄﾞｳﾃｷｷｮﾄﾞｳ	動的挙動	名詞
ﾄﾞｳﾃｷﾈﾝﾀﾞﾝｾｲ	動的粘弾性	名詞
ﾄﾞｳﾃｷｼﾞｶﾘﾂ	動的磁化率	名詞
ﾄﾞｳﾁｺｳｼｷﾝｼﾞ	同値光子近似	名詞
ﾄﾞｳﾄｸｾｲ	動特性	名詞
ﾄﾞｳﾁｮｳｿﾞｳﾌｸｷ	同調増幅器	名詞
ﾄﾞｳﾁｭｳｾｲｼｶｸ	同中性子核	名詞
ﾄﾞｳｼﾞｹﾞﾝﾉﾎｳｿｸ	同次元の法則	名詞
ﾄﾞｳｼﾞﾊﾝｼｬ	同時反射	名詞
ﾄﾞｳｼﾞｶｲﾛ	同時回路	名詞
ﾄﾞｳｼﾞｹｲｽｳﾎｳ	同時計数法	名詞
ﾄﾞｳｼﾞｹｲｽｳｶｲﾛ	同時計数回路	名詞
ﾄﾞｳｼﾞｸﾊﾁｮｳｹｲ	同軸波長計	名詞
ﾄﾞｳｼﾞｸｹｰﾌﾞﾙ	同軸ケーブル	名詞
ﾄﾞｳｼﾞｸｺﾈｸﾀｰ	同軸コネクター	名詞
ﾄﾞｳｼﾞｸｷｮｳｼﾝｷ	同軸共振器	名詞
ﾄﾞｳｼﾞｸｽｲｯﾁ	同軸スイッチ	名詞
ﾄﾞｳｼﾞｾｲ	同時性	名詞
ﾄﾞｼﾞｯﾀｰﾉｳﾁｭｳ	ドジッターの宇宙	名詞
ﾄﾞｳｿﾞｸﾀｲ	同族体	名詞
ﾄﾞｼﾞｪﾝﾇｲﾝｼ	ドジェンヌ因子	名詞
ﾄﾞｳｼﾞｭｳｶｸ	同重核	名詞
ﾃﾞｭｴﾇﾊﾝﾄﾉﾎｳｿｸ	デュエヌ・ハントの法則	名詞
ﾃﾞｭﾌｫｰｺｳｶ	デュフォー効果	名詞
ﾃﾞｭﾓﾝﾄﾞｽﾞﾋｮｳ	デュモンド図表	名詞
ﾃﾞｭｵﾋﾟｶﾞﾄﾛﾝ	デュオピガトロン	名詞
ﾃﾞｭｵﾌﾟﾗｽﾞﾏﾄﾛﾝ	デュオプラズマトロン	名詞
ﾃﾞｭﾛﾝﾌﾟﾃｨﾉﾎｳｿｸ	デュロン・プティの法則	名詞
ｴﾀﾞｻｸﾀｲ	EDA錯体	名詞
ｴｶﾃｲ	e過程	名詞
ｴﾑﾀﾝｲｹｲ	emu単位系	名詞
ｴSCｱ	ESCA	名詞
ｴｽｶ	エスカ	名詞
ｴｽﾀﾝｲｹｲ	esu単位系	名詞
ｴｧFS	EXAFS	名詞
ｴｸｻﾞﾌｽ	エクザフス	名詞
ｴｱﾘｰ	エアリー	人名
ｴｱﾘｰ	Airy	人名
ｴｱﾘｰﾃﾞｨｽｸ	エアリーディスク	名詞
ｴｱﾘｰｶﾝｽｳ	エアリー関数	名詞
ｴｱﾘｰﾉｼｷ	エアリーの式	名詞
ｴｱﾘｰｿﾞｳ	エアリー像	名詞
ｴﾃﾞｨﾝﾄﾝｹﾞﾝｶｲ	エディントン限界	名詞
ｴｷｿﾞﾃｨｯｸｹﾞﾝｼ	エキゾティック原子	名詞
ｴｲﾋﾞﾝｼｮｸ	鋭敏色	名詞
ｴｲﾋﾞﾝｼｮｸﾊﾞﾝ	鋭敏色板	名詞
ｴｲﾌｪﾝﾜﾙﾄﾉｼﾞｯｹﾝ	エイフェンワルトの実験	名詞
ｴｲｹｲﾚﾂ	鋭系列	名詞
ｴｲｷｭｳﾃﾞﾝﾘｭｳ	永久電流	名詞
ｴｲｷｭｳﾋｽﾞﾐ	永久ひずみ	名詞
ｴｲｷｭｳｷｶﾝ	永久機関	名詞
ｴｲｷｭｳｳﾝﾄﾞｳ	永久運動	名詞
ｴｲｷｭｳｼﾞﾊﾞ	永久磁場	名詞
ｴｲｷｭｳｼﾞｼｬｸ	永久磁石	名詞
ｴｲﾈﾝﾍﾝｶ	永年変化	名詞
ｴｲﾈﾝﾎｳﾃｲｼｷ	永年方程式	名詞
ｴｲﾈﾝｶｿｸ	永年加速	名詞
ｴｲﾈﾝｾﾂﾄﾞｳ	永年摂動	名詞
ｴｲｾｲﾊﾝｼｬ	衛星反射	名詞
ｴｲｾｲｾﾝ	衛星線	名詞
ｴｲｼﾝ	映進	名詞
ｴｲｼﾝﾒﾝ	映進面	名詞
ｴｲｼﾝﾀｲｼｮｳ	映進対称	名詞
ｴｲｼｾｲ	えい糸性	名詞
ｴｲｼｾｲ	曳糸性	名詞
ｴｲｿﾞｳﾃﾞﾝｶ	映像電荷	名詞
ｴｲｿﾞﾝｾﾝ	永存線	名詞
ｴｲｿﾞｳﾊﾟﾗﾒｰﾀｰ	影像パラメーター	名詞
ｴｲｿﾞｳﾘｮｸ	映像力	名詞
ｴｲｿﾞｳｼﾝｺﾞｳ	影像信号	名詞
ｴｲｿﾞｳｿﾞｳｷｮｳｶﾝ	影像増強管	名詞
ｴｷｶｷ	液化機	名詞
ｴｷﾒﾝｹｲ	液面計	名詞
ｴｷｼﾏｰ	エキシマー	名詞
ｴｷｼﾝ	液浸	名詞
ｴｷｼﾄﾆｯｸｿｳ	エキシトニック相	名詞
ｴｷｿｳ	液相	名詞
ｴｷｿﾃﾞﾝｼ	エキソ電子	名詞
ｴｷｿｳｾｲﾁｮｳ	液相成長	名詞
ｴｷｿｳｾﾝ	液相線	名詞
ｴｷｽﾄﾗｸﾀｰｹﾞｰｼﾞ	エキストラクターゲージ	名詞
ｴｷｽﾄﾘﾝｼｯｸ	エキストリンシック	名詞
ｾｷｿｳｹｯｶﾝ	積層欠陥	名詞
ｴｷﾀｲｺﾞｳｷﾝ	液体合金	名詞
ｴｷﾀｲﾊﾄﾞｳ	液体波動	名詞
ｴｷﾀｲﾊｲｷﾌﾞﾂ	液体廃棄物	名詞
ｴｷﾀｲﾍﾘｳﾑ	液体ヘリウム	名詞
ｴｷﾀｲﾋｮｳﾃｷ	液体標的	名詞
ｴｷﾀｲｷﾝｿﾞｸ	液体金属	名詞
ｴｷﾀｲｸｳｷ	液体空気	名詞
ｴｷﾀｲｷｭｳﾚｲｷﾝｿﾞｸ	液体急冷金属	名詞
ｴｷﾀﾝﾈﾝﾘｮｳﾛ	液体燃料炉	名詞
ｴｷﾀｲｵﾝﾄﾞｹｲ	液体温度計	名詞
ｴｷﾀｲﾚｰｻﾞｰ	液体レーザー	名詞
ｴｷﾀｲｻﾝｿ	液体酸素	名詞
ｴｷﾀｲｼﾝﾁﾚｰﾀｰ	液体シンチレーター	名詞
ｴｷﾀｲｽｲｿ	液体水素	名詞
ｴｷﾀｲﾃｲｺｳｷ	液体抵抗器	名詞
ｴｷﾀｲﾁｯｿ	液体窒素	名詞
ｴｷﾃｷﾓｹｲ	液滴模型	名詞
ｴｷﾁｭｳｱﾂﾘｮｸｹｲ	液柱圧力計	名詞
ｴｸﾏﾝｿｳ	エクマン層	名詞
ｴｸｾﾙｷﾞｰ	エクセルギー	名詞
ｴｸｽｸﾙｰｼﾌﾞﾊﾝﾉｳ	エクスクルーシブ反応	名詞
ｴﾏﾙｼｮﾝ	エマルション	名詞
ｴﾏﾙｼｮﾝﾁｪﾝﾊﾞｰ	エマルションチェンバー	名詞
ｴﾐｯｼｮﾝﾒｼﾞｬｰ	エミッションメジャー	名詞
ｴﾐｯﾀｰ	エミッター	名詞
ｴﾐｯﾀｰﾎﾛﾜｰ	エミッターホロワー	名詞
ｴﾐｯﾀﾝｽ	エミッタンス	名詞
ｴﾝﾊﾞﾝｼｭｿﾞｸ	円盤種族	名詞
ｴﾝﾌﾞﾘｵ	エンブリオ	名詞
ｴﾝﾃﾞﾝﾘｭｳ	円電流	名詞
ｴﾝﾄﾞﾎﾟｲﾝﾄﾄｸｲｾｲ	エンドポイント特異性	名詞
ｴﾈﾙｹﾞﾃｨｰｸ	エネルゲティーク	名詞
ｴﾈﾙｷﾞｰﾊﾞﾝﾄﾞ	エネルギーバンド	名詞
ｴﾈﾙｷﾞｰﾀｲ	エネルギー帯	名詞
ｴﾈﾙｷﾞｰﾌﾞﾝﾌﾟ	エネルギー分布	名詞
ﾌﾞﾝｻﾝｶﾞﾀXｾﾝﾌﾞﾝｺｳ	分散型X線分光	名詞
ｴﾈﾙｷﾞｰﾌﾞﾝｾｷｷ	エネルギー分析器	名詞
ｴﾈﾙｷﾞｰﾀﾞﾝｾｲ	エネルギー弾性	名詞
ｴﾈﾙｷﾞｰﾃﾞﾝﾊﾟﾝｿｸﾄﾞ	エネルギー伝搬速度	名詞
ｴﾈﾙｷﾞｰﾃﾞﾝﾀﾂ	エネルギー伝達	名詞
ｴﾈﾙｷﾞｰｷﾞｬｯﾌﾟ	エネルギーギャップ	名詞
ｴﾈﾙｷﾞｰﾊﾊﾞ	エネルギー幅	名詞
ｴﾈﾙｷﾞｰﾍﾝｶﾝ	エネルギー変換	名詞
ｴﾈﾙｷﾞｰﾎｿﾞﾝｿｸ	エネルギー保存則	名詞
ｴﾈﾙｷﾞｰﾋｮｳﾒﾝ	エネルギー表面	名詞
ｴﾈﾙｷﾞｰｲｺｳ	エネルギー移行	名詞
ｴﾈﾙｷﾞｰｲｿﾞﾝｾｲ	エネルギー依存性	名詞
ｴﾈﾙｷﾞｰｷｮｸﾒﾝ	エネルギー曲面	名詞
ｴﾈﾙｷﾞｰﾐﾂﾄﾞ	エネルギー密度	名詞
ｴﾈﾙｷﾞｰﾉﾅｶﾞﾚ	エネルギーの流れ	名詞
ｻﾝｲﾂｷｮｸｼｮｳﾉｹﾞﾝﾘ	散逸極小の原理	名詞
ｴﾈﾙｷﾞｰｾﾝﾍﾞﾂｷ	エネルギー選別器	名詞
ｴﾈﾙｷﾞｰｿﾝｼﾂ	エネルギー損失	名詞
ｴﾈﾙｷﾞｰｿﾝｼﾂｽﾍﾟｸﾄﾙ	エネルギー損失スペクトル	名詞
ｴﾈﾙｷﾞｰｽﾍﾟｸﾄﾙ	エネルギースペクトル	名詞
ｴﾈﾙｷﾞｰﾄｳﾌﾞﾝﾊﾟｲ	エネルギー等分配	名詞
ｳﾝﾄﾞｳﾘｮｳﾃﾝｿﾙ	-運動量テンソル	名詞
ｴﾈﾙｷﾞｰｿﾞﾝ	エネルギー損	名詞
ｴﾈﾙｷﾞｰｼﾞｭﾝｲ	エネルギー準位	名詞
ｴﾝﾍﾝｺｳ	円偏光	名詞
ｴﾝﾍﾝｺｳﾊﾞﾝ	円偏光板	名詞
ｴﾝﾍﾝｺｳﾆｼｮｸｾｲ	円偏光二色性	名詞
ｴﾝﾌﾘｺ	円振り子	名詞
ｴﾝｶｸｻﾖｳ	遠隔作用	名詞
ｴﾝｶｸｾｲｷﾞｮ	遠隔制御	名詞
ｴﾝｶｸｿｸﾃｲ	遠隔測定	名詞
ｴﾝｶｸｼｮｳﾄﾂ	遠隔衝突	名詞
ｴﾝｶﾅﾄﾘｳﾑｶﾞﾀｺｳｿﾞｳ	塩化ﾅﾄﾘｳﾑ型構造	名詞
ｴﾝｶｾｼｳﾑｶﾞﾀｺｳｿﾞｳ	塩化ｾｼｳﾑ型構造	名詞
ｴﾝｹｲｶｿｸｷ	円型加速器	名詞
ｴﾝｹｲｺｲﾙ	円形コイル	名詞
ｴﾝｺｰﾀﾞｰ	エンコーダー	名詞
ｴﾝｺｳｽﾍﾟｸﾄﾙ	炎光スペクトル	名詞
ｴﾝｷｮﾘｵﾝﾊﾞ	遠距離音場	名詞
ｴﾝｷｮﾘﾘｮｸ	遠距離力	名詞
ｴﾝﾀﾂﾘｮｸ	遠達力	名詞
ｴﾝｷｮﾘｿｳｺﾞｻﾖｳ	遠距離相互作用	名詞
ｴﾝﾒﾝﾎｳﾃﾞﾝ	沿面放電	名詞
ｴﾝﾍﾟｲ	えん蔽	名詞
ｴﾝｾｲ	延性	名詞
ｴﾝｾｷｶﾞｲﾚｰｻﾞｰ	遠赤外レーザー	名詞
ｴﾝｾｷｶﾞｲｾﾝ	遠赤外線	名詞
ｴﾝｾｷｶﾞｲｽﾍﾟｸﾄﾙ	遠赤外スペクトル	名詞
ｴﾝｼﾝ	延伸	名詞
ｴﾝｼﾝﾌﾞﾝｶｸ	遠心分画	名詞
ｴﾝｼﾝﾌﾞﾝﾘ	遠心分離	名詞
ｴﾝｼﾝﾌﾞﾝﾘｷ	遠心分離器	名詞
ｴﾝｼﾝｷ	遠心機	名詞
ｴﾝｼﾝﾘｮｸﾋｽﾞﾐ	遠心力ひずみ	名詞
ｴﾝｼﾔｿﾞｳ	遠視野像	名詞
ｴﾝｽｲﾌﾘｺ	円錐振り子	名詞
ｴﾝｽｲｸｯｾﾂ	円錐屈折	名詞
ｴﾝﾀﾙﾋﾟｰ	エンタルピー	名詞
ｴﾝﾄﾛﾋﾟｰ	エントロピー	名詞
ｴﾝﾄﾛﾋﾟｰﾀﾞﾝｾｲ	エントロピー弾性	名詞
ｴﾝﾄﾛﾋﾟｰﾉﾅﾐ	エントロピーの波	名詞
ｴﾝﾄﾛﾋﾟｰｿﾞｳﾀﾞｲｿｸ	エントロピー増大則	名詞
ｴﾝﾄｳｻﾞﾋｮｳ	円筒座標	名詞
ｴﾝﾁｮｸｾﾝ	鉛直線	名詞
ｴﾝﾁｭｳｶﾝｽｳ	円柱関数	名詞
ｴﾝﾁｭｳﾚﾝｽﾞ	円柱レンズ	名詞
ｴﾝｳﾝﾄﾞｳ	円運動	名詞
ｴﾝｻﾞﾝｶｲﾛ	演算回路	名詞
ｴﾝｻﾞﾝｼ	演算子	名詞
ｴﾝｻﾞﾝｼﾎｳ	演算子法	名詞
ｴﾝｻﾞﾝｿﾞｳﾌｸｷ	演算増幅器	名詞
ｴﾝｼﾞﾂﾃﾝ	遠日点	名詞
ｴｵﾙｽｵﾝ	エオルス音	名詞
ｴﾋﾟｿｰﾑ	エピソーム	名詞
ｴﾋﾟﾀｷｼｱﾙｶﾞﾀ	エピタキシアル型	名詞
ｴﾋﾟﾀｷｼｱﾙｾｲﾁｮｳ	エピタキシアル成長	名詞
ｴﾋﾟﾀｷｼｰ	エピタキシー	名詞
ｴﾚｸﾄﾚｯﾄ	エレクトレット	名詞
ｴﾚｸﾄﾛﾏｲｸﾞﾚｰｼｮﾝ	エレクトロマイグレーション	名詞
ｴﾚｸﾄﾛﾙﾐﾈﾝｽ	エレクトロルミネンス	名詞
ｴｰﾚﾝﾌｪｽﾄﾉﾃｲﾘ	エーレンフェストの定理	名詞
ｴﾘｸｿﾝｻｲｸﾙ	エリクソンサイクル	名詞
ｴｰﾘﾝｸﾞﾊｳｽ	エーリングハウス	人名
ｴﾘｵｯﾄｷｺｳ	エリオット機構	名詞
ｴｰﾛｿﾞﾙ	エーロゾル	名詞
ｴﾙｺﾞｰﾄﾞｶｾﾂ	エルゴード仮説	名詞
ｴﾙｺﾞｰﾄﾞｾｲ	エルゴード性	名詞
ｴﾙｺﾞｰﾄﾞﾃｲﾘ	エルゴード定理	名詞
ｴﾙﾐｰﾄｴﾝｻﾞﾝｼ	エルミート演算子	名詞
ｴﾙﾐｰﾄｷﾞｮｳﾚﾂ	エルミート行列	名詞
ｴﾙﾐｰﾄｹｲｼｷ	エルミート形式	名詞
ｴﾙﾐｰﾄﾀｺｳｼｷ	エルミート多項式	名詞
ｴﾙｽﾀｰｶﾞｲﾃﾙｺｳｶ	エルスター・ガイテル効果	名詞
ｴﾙｽﾃｯﾄﾞ	エルステッド	名詞
ｴｻｷﾀﾞｲｵｰﾄﾞ	江崎ダイオード	名詞
ｴｼｪﾚｯﾄｺｳｼ	エシェレット光子	名詞
ｴｼｪﾙ	エシェル	名詞
ｴｼｪﾙﾌﾞﾝｺｳｷ	エシェル分光器	名詞
ｴｼｭﾛﾝ	エシュロン	名詞
ｴﾀﾝﾃﾞｭ	エタンデュ	名詞
ｴﾀﾛﾝ	エタロン	名詞
ｴﾄﾍﾞｯｼｭﾉｼﾞｯｹﾝ	エトベッシュの実験	名詞
ｴｯﾁﾝｸﾞ	エッチング	名詞
ｴｯﾃｨﾝｸﾞｽﾊｳｾﾞﾝｺｳｶ	エッティングスハウゼン効果	名詞
ｴｯﾁﾋﾟｯﾄ	エッチピット	名詞
ｴﾜﾙﾄﾞ	エワルド	人名
ｴﾜﾙﾄﾞ	Ewald	人名
ｴﾜﾙﾄﾞｷｭｳ	エワルド球	名詞
ｴﾜﾙﾄﾞﾉﾎｳﾎｳ	エワルドの方法	名詞
ｴﾜﾙﾄﾞﾉｻｸｽﾞ	エワルドの作図	名詞
ｴｾﾞｸﾀｰ	エゼクター	名詞
ｴｾﾞｸﾀｰﾎﾟﾝﾌﾟ	エゼクターポンプ	名詞
ｴｼﾞｿﾝ	エジソン	人名
ｴｼﾞｿﾝ	Edison	人名
ｴｼﾞｿﾝｺｳｶ	エジソン効果	名詞
ｴｯｼﾞﾌｫｰｶｽ	エッジフォーカス	名詞
ｴｯｼﾞｵﾝ	エッジ音	名詞
Fｷﾄﾞｳ	f軌道	名詞
Fｶﾝｽｳ	f関数	名詞
FMｻｲｸﾛﾄﾛﾝ	FMサイクロトロン	名詞
Fｽｳ	F数	名詞
Fﾁ	f値	名詞
Fｯﾁ	ft値	名詞
Fﾁｭｳｼﾝ	F中心	名詞
Fﾁｭｳｼﾝﾚｰｻﾞｰ	F中心レーザー	名詞
ﾌｧﾋﾞﾄﾛﾝ	ファビトロン	名詞
ﾌｧﾌﾞﾘｰﾍﾟﾛｰ	ファブリー・ペロー	人名
ｶﾝｼｮｳｹｲ	干渉計	名詞
ﾌｧﾌﾞﾘｰﾍﾟﾛｰｷｮｳｼﾝｷ	ファブリー・ペロー共振器	名詞
ﾌｧﾌﾞﾘｰﾍﾟﾛｰﾉｴﾀﾛﾝ	ファブリー・ペローのエタロン	名詞
ﾌｧﾃﾞｰｴﾌﾎｳﾃｲｼｷ	ファデーエフ方程式	名詞
ﾌｧｲﾊﾞｰｵﾌﾟﾃｨｯｸｽ	ファイバーオプティックス	名詞
ﾌｧｲﾝﾏﾝ	ファインマン	人名
ﾌｧｲﾝﾏﾝ	Feynman	人名
ﾌｧｲﾝﾏﾝﾀﾞｲﾔｸﾞﾗﾑ	ファインマンダイアグラム	名詞
ﾌｧｲﾝﾏﾝﾀﾞｲﾔｸﾞﾗﾑ	ファインマンダイヤグラム	名詞
ﾌｧｲﾝﾏﾝﾉｹｲﾛｾｷﾌﾞﾝ	ファインマンの経路積分	名詞
ﾌｧｲﾝﾏﾝﾛｽﾎｳ	ファインマン・ロス法	名詞
ﾌｧｲﾝﾏﾝｾｷﾌﾞﾝ	ファインマン積分	名詞
ﾌｧｲﾝﾏﾝｿｸ	ファインマン則	名詞
ﾌｧｲﾝﾏﾝｽｹｰﾘﾝｸﾞ	ファインマンスケーリング	名詞
ﾌｧﾝﾃﾞﾙﾎﾟｰﾙﾎｳﾃｲｼｷ	ファンデルポール方程式	名詞
ﾌｧﾝﾃﾞﾙﾜｰﾙｽ	ファンデルワールス	人名
ﾌｧﾝﾃﾞﾙﾜｰﾙｽ	vanderWaals	人名
ﾌｧﾝﾃﾞﾙﾜｰﾙｽﾌﾞﾝｼ	ファンデルワールス分子	名詞
ﾌｧﾝﾃﾞﾙﾜｰﾙｽｹｯｼｮｳ	ファンデルワールス結晶	名詞
ﾌｧﾝﾃﾞﾙﾜｰﾙｽｹﾂｺﾞｳ	ファンデルワールス結合	名詞
ｼﾞｮｳﾀｲﾎｳﾃｲｼｷ	状態方程式	名詞
ﾌｧﾝﾃﾞﾙﾜｰﾙｽﾘｮｸ	ファンデルワールス力	名詞
ﾌｧﾝﾎｰﾍﾞ	ファンホーベ	人名
ﾌｧﾝﾎｰﾍﾞ	vanHove	人名
ﾌｧﾝﾎｰﾍﾞﾉｻﾝﾗﾝｺｳｼｷ	ファンホーベの散乱公式	名詞
ﾌｧﾝﾎｰﾍﾞﾉｼｷ	ファンホーベの式	名詞
ﾌｧﾝﾎｰﾍﾞﾄｸｲﾃﾝ	ファンホーベ特異点	名詞
ﾌｧﾉｲﾝｼ	ファノ因子	名詞
ﾌｧﾉﾘﾋﾃﾝﾘﾛﾝ	ファノ・リヒテン理論	名詞
ﾌｧﾝﾄﾎｯﾌ	ﾌｧﾝﾄﾎｯﾌ	人名
ﾌｧﾝﾄﾎｯﾌ	van'tHoff	人名
ﾌｧﾝﾄﾎｯﾌｹｲｽｳ	ファントホッフ係数	名詞
ｼﾝﾄｳｱﾂﾉﾎｳｿｸ	浸透圧の法則	名詞
ﾌｧﾝﾄﾑ	ファントム	名詞
ﾌｧﾗﾃﾞｰ	ファラデー	人名
ﾌｧﾗﾃﾞｰ	Faraday	人名
ﾌｧﾗﾃﾞｰｱﾝﾌﾞ	ファラデー暗部	名詞
ﾌｧﾗﾃﾞｰｶｯﾌﾟ	ファラデーカップ	名詞
ﾌｧﾗﾃﾞｰｹｰｼﾞ	ファラデーケージ	名詞
ﾌｧﾗﾃﾞｰｺｳｶ	ファラデー効果	名詞
ﾃﾞﾝｼﾞﾕｳﾄﾞｳﾉﾎｳｿｸ	電磁誘導の法則	名詞
ﾌｧﾗﾃﾞｰﾃｲｽｳ	ファラデー定数	名詞
ﾌｧﾗﾄﾞ	ファラド	名詞
ﾌｧﾘｰﾉﾃｲﾘ	ファリーの定理	名詞
ﾌｧｳﾝﾃﾝｺｳｶ	ファウンテン効果	名詞
ﾌｧｳﾗｰﾌﾟﾛｯﾄ	ファウラープロット	名詞
ﾌｪｲﾝﾃﾞｨﾝｸﾞ	フェインディング	名詞
ﾌｪｲﾝｿﾞﾝ	フェインゾン	名詞
ﾌｪﾑﾄﾋﾞｮｳﾌﾞﾝｺｳ	フェムト秒分光	名詞
ﾌｪﾗｲﾄ	フェライト	名詞
ﾌｪﾗｲﾄｷｮｳｼﾝｷ	フェライト共振器	名詞
ﾌｪﾗｲﾄｼﾝﾄﾞｳｼ	フェライト振動子	名詞
ﾌｪﾘｰﾌﾟﾘｽﾞﾑ	フェリープリズム	名詞
ﾌｪﾘﾕｳﾃﾞﾝｾｲ	フェリ誘電性	名詞
ﾌｪﾘﾕｳﾃﾞﾝﾀｲ	フェリ誘電体	名詞
ﾌｪﾘｼﾞｷｷｮｳﾒｲ	フェリ磁気共鳴	名詞
ﾌｪﾘｼﾞｾｲ	フェリ磁性	名詞
ﾌｪﾘｼﾞｾｲﾀｲ	フェリ磁性体	名詞
ﾌｪﾙﾍﾞｰﾃﾝｲ	フェルベー転移	名詞
ﾌｪﾙｹﾞｯﾄﾉﾘﾄｸ	フェルゲットの利得	名詞
ﾌｪﾙﾏｰﾉｹﾞﾝﾘ	フェルマーの原理	名詞
ﾌｪﾙﾐ	フェルミ	人名
ﾌｪﾙﾐ	Fermi	人名
ﾌｪﾙﾐﾌﾞﾝﾌﾟ	フェルミ分布	名詞
ﾌｪﾙﾐﾃﾞｨﾗｯｸﾌﾞﾝﾌﾟ	フェルミ・ディラック分布	名詞
ﾌｪﾙﾐﾃﾞｨﾗｯｸﾄｳｹｲ	フェルミ・ディラック統計	名詞
ﾌｪﾙﾐｴｷﾀｲ	フェルミ液体	名詞
ﾌｪﾙﾐｴﾈﾙｷﾞｰ	フェルミエネルギー	名詞
ﾌｪﾙﾐｶﾞｽﾓｹｲ	フェルミガス模型	名詞
ﾌｪﾙﾐｶﾞﾀｾﾝｲ	フェルミ型遷移	名詞
ﾌｪﾙﾐｸﾞﾗｽ	フェルミグラス	名詞
ﾌｪﾙﾐﾊｽｳ	フェルミ波数	名詞
ﾌｪﾙﾐｶｿｸ	フェルミ加速	名詞
ﾌｪﾙﾐｷﾀｲ	フェルミ気体	名詞
ﾌｪﾙﾐｸｳｺｳ	フェルミ空孔	名詞
ﾌｪﾙﾐｷｮｳﾒｲ	フェルミ共鳴	名詞
ﾌｪﾙﾐｷｭｳ	フェルミ球	名詞
ﾌｪﾙﾐﾒﾝ	フェルミ面	名詞
ﾌｪﾙﾐﾈﾝﾚｲ	フェルミ年齢	名詞
ﾌｪﾙﾐﾉｵｳｺﾞﾝﾘﾂ	フェルミの黄金律	名詞
ｾｯｼｮｸｿｳｺﾞｻﾖｳ	接触相互作用	名詞
ﾌｪﾙﾐｵﾝ	フェルミオン	名詞
ﾌｪﾙﾐｵﾛｼﾞｰ	フェルミオロジー	名詞
ﾌｪﾙﾐﾘｭｳｼ	フェルミ粒子	名詞
ﾌｪﾙﾐｿｳｺﾞｻﾖｳ	フェルミ相互作用	名詞
ﾌｪﾙﾐｿｸﾄﾞ	フェルミ速度	名詞
ﾌｪﾙﾐﾄｳｹｲ	フェルミ統計	名詞
ﾌｪﾙﾐｳﾝﾄﾞｳﾘｮｳ	フェルミ運動量	名詞
ﾌｪﾙﾐｼﾞｭﾝｲ	フェルミ準位	名詞
ﾌｪﾙｽﾀｰﾓｹｲ	フェルスター模型	名詞
ﾌｨﾌﾞﾘﾙ	フィブリル	名詞
ﾌｨﾃﾞｭｰｼｬﾙﾏｰｸ	フィデューシャルマーク	名詞
ﾌｨｰﾄﾞﾌｫﾜｰﾄﾞｾｲｷﾞｮ	フィードフォワード制御	名詞
ﾌｨｰﾄﾞｽﾙｰ	フィードスルー	名詞
ﾌｨｯｸﾉﾎｳｿｸ	フィックの法則	名詞
ﾌｨﾈｽ	フィネス	名詞
ﾌｨﾗﾒﾝﾄ	フィラメント	名詞
ﾌｨﾙﾑﾊﾞｯｼﾞ	フィルムバッジ	名詞
ﾌｨﾙﾑｾﾝﾘｮｳｹｲ	フィルム線量計	名詞
ﾌｨﾙﾑｾﾝﾘｮｳｿｸﾃｲ	フィルム線量測定	名詞
ﾌｨﾙｿﾌﾉﾘﾛﾝ	フィルソフの理論	名詞
ﾌｨﾙｼｭｼｭﾙﾀｰｲﾝｼ	フィルシュ・シュルター因子	名詞
ﾌｨｰﾙﾂﾍﾝｶﾝ	フィールツ変換	名詞
ﾌｨｿﾞｰｶﾝｼｮｳｹｲ	フィゾー干渉計	名詞
ﾌｨｿﾞｰﾉﾎｳﾎｳ	フィゾーの方法	名詞
ﾌｫｰﾌﾞｯｼｭｹﾞﾝｼｮｳ	フォーブッシュ減少	名詞
ﾌｫｯｶｰﾌﾟﾗﾝｸﾎｳﾃｲｼｷ	フォッカー・プランク方程式	名詞
ﾌｫｯｸﾋｮｳｼﾞ	フォック表示	名詞
ﾌｫｯｸｸｳｶﾝ	フォック空間	名詞
ﾌｫｰｸﾄｺｳｶ	フォークト効果	名詞
ﾌｫｰｸﾄﾓｹｲ	フォークト模型	名詞
ﾌｫﾝﾉｲﾏﾝ	ﾌｫﾝﾉｲﾏﾝ	人名
ﾌｫﾝﾉｲﾏﾝ	vonNeumann	人名
ﾌｫﾝﾉｲﾏﾝﾉｲﾁｲｾｲﾃｲﾘ	フォンノイマンの一意性定理	名詞
ﾌｫﾉﾝ	フォノン	名詞
ﾌｫﾉﾝﾄﾞﾗｯｸﾞ	フォノンドラッグ	名詞
ﾌｫﾉﾝｴｺｰ	フォノンエコー	名詞
ﾌｫﾉﾝﾚｲｷ	フォノン励起	名詞
ﾌｫﾉﾝｻﾝﾗﾝ	フォノン散乱	名詞
ﾌｫﾉﾝｿﾞｳﾌｸ	フォノン増幅	名詞
ﾌｫﾙﾀﾝｷｱﾂｹｲ	フォルタン気圧計	名詞
ﾌｫﾙﾄﾗﾎｳﾌﾞﾂｾﾝ	フォルトラ放物線	名詞
ﾌｫﾙﾄﾗｽﾞ	フォルトラ図	名詞
ｶﾞﾝﾏﾌﾞﾝｻﾝ	γ分散	名詞
ｶﾞﾝﾏﾌﾞﾝｻﾝ	$\gamma$分散	名詞
ｶﾞﾝﾏﾌﾞﾝｻﾝ	\gamma分散	名詞
ｶﾞﾝﾏｷﾞｮｳﾚﾂ	γ行列	名詞
ｶﾞﾝﾏｷﾞｮｳﾚﾂ	$\gamma$行列	名詞
ｶﾞﾝﾏｷﾞｮｳﾚﾂ	\gamma行列	名詞
ｶﾞﾝﾏﾎｳｶｲ	γ崩壊	名詞
ｶﾞﾝﾏﾎｳｶｲ	$\gamma$崩壊	名詞
ｶﾞﾝﾏﾎｳｶｲ	\gamma崩壊
ｶﾞﾝﾏｶﾝｽｳ	Γ関数	名詞
ｶﾞﾝﾏｶﾝｽｳ	${\mit\Gamma}$関数	名詞
ｶﾞﾝﾏｶﾝｽｳ	{\mit\Gamma}関数	名詞
ｶﾞﾝﾏｶﾝﾜ	γ緩和	名詞
ｶﾞﾝﾏｶﾝﾜ	$\gamma$緩和	名詞
ｶﾞﾝﾏｶﾝﾜ	\gamma緩和	名詞
ｶﾞﾝﾏｸｳｶﾝ	Γ空間	名詞
ｶﾞﾝﾏｸｳｶﾝ	${\mit\Gamma}$空間	名詞
ｶﾞﾝﾏｸｳｶﾝ	{\mit\Gamma}空間	名詞
ｶﾞﾝﾏｾﾝ	γ線	名詞
ｶﾞﾝﾏｾﾝ	$\gamma$線	名詞
ｶﾞﾝﾏｾﾝ	\gamma線	名詞
ｶﾞﾝﾏｾﾝﾌﾞﾝｺｳｶﾞｸ	γ線分光学	名詞
ｶﾞﾝﾏｾﾝﾌﾞﾝｺｳｶﾞｸ	$\gamma$線分光学	名詞
ｶﾞﾝﾏｾﾝﾌﾞﾝｺｳｶﾞｸ	\gamma線分光学	名詞
ｶﾞﾝﾏｾﾝｲ	γ遷移	名詞
ｶﾞﾝﾏｾﾝｲ	$\gamma$遷移	名詞
ｶﾞﾝﾏｾﾝｲ	\gamma遷移	名詞
ｶﾞﾝﾏｾﾝｹﾝｼｭﾂｷ	γ線検出器	名詞
ｶﾞﾝﾏｾﾝｹﾝｼｭﾂｷ	$\gamma$線検出器	名詞
ｶﾞﾝﾏｾﾝｹﾝｼｭﾂｷ	\gamma線検出器	名詞
ｶﾞﾝﾏｾﾝﾘｮｳｿｸﾃｲ	γ線量測定	名詞
ｶﾞﾝﾏｾﾝﾘｮｳｿｸﾃｲ	$\gamma$線量測定	名詞
ｶﾞﾝﾏｾﾝﾘｮｳｿｸﾃｲ	\gamma線量測定	名詞
ｶﾞﾝﾏｾﾝｻﾝﾗﾝ	γ線散乱	名詞
ｶﾞﾝﾏｾﾝｻﾝﾗﾝ	$\gamma$線散乱	名詞
ｶﾞﾝﾏｾﾝｻﾝﾗﾝ	\gamma線散乱	名詞
ｶﾞﾝﾏｾﾝｽﾍﾟｸﾄﾛﾒｰﾀｰ	γ線スペクトロメーター	名詞
ｶﾞﾝﾏｾﾝｽﾍﾟｸﾄﾛﾒｰﾀｰ	$\gamma$線スペクトロメーター	名詞
ｶﾞﾝﾏｾﾝｽﾍﾟｸﾄﾛﾒｰﾀｰ	\gamma線スペクトロメーター	名詞
ｶﾞﾝﾏｾﾝｼｮｳｼｬ	γ線照射	名詞
ｶﾞﾝﾏｾﾝｼｮｳｼｬ	$\gamma$線照射	名詞
ｶﾞﾝﾏｾﾝｼｮｳｼｬ	\gamma線照射	名詞
ｶﾞﾝﾏｾﾝﾃﾝﾓﾝｶﾞｸ	γ線天文学	名詞
ｶﾞﾝﾏｾﾝﾃﾝﾓﾝｶﾞｸ	$\gamma$線天文学	名詞
ｶﾞﾝﾏｾﾝﾃﾝﾓﾝｶﾞｸ	\gamma線天文学	名詞
ｶﾞﾝﾏｼﾝﾄﾞｳ	γ振動	名詞
ｶﾞﾝﾏｼﾝﾄﾞｳ	$\gamma$振動	名詞
ｶﾞﾝﾏｼﾝﾄﾞｳ	\gamma振動	名詞
ｶﾞﾝﾏﾁ	Γ値	名詞
ｶﾞﾝﾏﾁ	${\mit\Gamma}$値	名詞
ｶﾞﾝﾏﾁ	{\mit\Gamma}値	名詞
gbｾｷ	GB積	名詞
ｷﾞﾝｼ	g因子	名詞
ｷﾞﾝｼ	{\itg}因子	名詞
gﾝｯｻｲｺｳｾｲﾃｲﾘ	GNS再構成定理	名詞
gﾊﾟﾘﾃｨ	Gパリティ	名詞
gmｹｲｽｳｶﾝ	GM計数管	名詞
GﾋﾟB	GP-IB	名詞
GPｿﾞｰﾝ	GPゾーン	名詞
Gﾄｻｲﾘｽﾀｰ	GTOサイリスター	名詞
ｶﾞﾌｼﾞｭｰﾙｺｳｶ	ガフ・ジュール効果	名詞
ｶﾞｲｱﾂﾘｮｸ	外圧力	名詞
ｶﾞｲﾋﾞﾌﾞﾝ	外微分	名詞
ｶﾞｲﾌﾞｴﾝｽｲｸｯｾﾂ	外部円錐屈折	名詞
ｶﾞｲﾌﾞｶｲ	外部解	名詞
ｶﾞｲﾌﾞｾﾝﾘｮｳ	外部線量	名詞
ｶﾞｲﾌﾞｼｮｳｼｬ	外部照射	名詞
ｶﾞｲﾌﾞｻﾞﾂｵﾝ	外部雑音	名詞
ｶﾞｲｶﾞｰﾐｭﾗｰｹｲｽｳｶﾝ	ガイガー・ミュラー計数管	名詞
ｶﾞｲｶﾞｰﾇｯﾀﾙﾉﾎｳｿｸ	ガイガー・ヌッタルの法則	名詞
ｶﾞｲﾋｮｳｼﾞｭﾝﾎｳ	外標準法	名詞
ｶﾞｲｲﾝｾｲﾊﾝﾄﾞｳﾀｲ	外因性半導体	名詞
ｶﾞｲｾｷ	外積	名詞
ｶﾞｲｿｳ	外挿	名詞
ｶﾞｲｽﾗｰｶﾝ	ガイスラー管	名詞
ｶﾞﾓﾌﾃﾗｰｶﾞﾀｾﾝｲ	ガモフ・テラー型遷移	名詞
ｶﾞﾝﾀﾞｲｵｰﾄﾞ	ガンダイオード	名詞
ｶﾞｰﾈｯﾄｶﾞﾀｺｳｿﾞｳ	ガーネット型構造	名詞
ｶﾞﾝｺｳｶ	ガン効果	名詞
ｶﾞﾝﾏｶﾒﾗ	ガンマカメラ	名詞
ｶﾞﾝｼﾝ	含浸	名詞
ｶﾞﾝﾄﾏｰｶｰｺｳｶ	ガントマーカー効果	名詞
ｶﾞﾗｽﾚｰｻﾞｰ	ガラスレーザー	名詞
ｶﾞﾗｽﾃﾝｲ	ガラス転移	名詞
ｶﾞﾗｽｼﾞｮｳﾀｲ	ガラス状態	名詞
ｶﾞﾚﾙｷﾝﾎｳ	ガレルキン法	名詞
ｶﾞﾘﾚｲﾍﾝｶﾝ	ガリレイ変換	名詞
ｶﾞﾘﾚｲﾉｿｳﾀｲｾｲｹﾞﾝﾘ	ガリレイの相対性原理	名詞
ｶﾞﾛｱﾘﾛﾝ	ガロア理論	名詞
ｶﾞﾙ	ガル	名詞
ｶﾞｽﾊﾞﾗｽﾄﾎﾟﾝﾌﾟ	ガスバラストポンプ	名詞
ｶﾞｽﾌﾞﾗﾝｹｯﾄ	ガスブランケット	名詞
ｶﾞｽﾀﾞｲﾅﾐｯｸﾚｰｻﾞｰ	ガスダイナミックレーザー	名詞
ｶﾞｽﾎｳｼｭﾂ	ガス放出	名詞
ｶﾞｽﾎｳｼｭﾂﾘﾂ	ガス放出率	名詞
ｶﾞｽﾌﾛｰｹｲｽｳｶﾝ	ガスフロー計数管	名詞
ｶﾞｽｷｶﾝﾛ	ガス帰還路	名詞
ｶﾞｽﾚｰｻﾞｰ	ガスレーザー	名詞
ｶﾞｽｾｲｳﾝ	ガス星雲	名詞
ｶﾞｽｼﾞｮｳｾｲｳﾝ	ガス状星雲	名詞
ｶﾞｯﾁﾎｳ	合致法	名詞
ｶﾞｳﾝﾄｲﾝｼ	ガウント因子	名詞
ｶﾞｳｽﾋﾞｰﾑ	ガウスビーム	名詞
ｶﾞｳｽﾌﾞﾝﾌﾟ	ガウス分布	名詞
ｶﾞｳｽｶﾞﾀｷﾄﾞｳｶﾝｽｳ	ガウス型軌道関数	名詞
ｶﾞｳｽｶﾃｲ	ガウス過程	名詞
ｶﾞｳｽｷﾝｼﾞ	ガウス近似	名詞
ｶﾞｳｽｺｳｶﾞｸ	ガウス光学	名詞
ｶﾞｳｽﾒｰﾀｰ	ガウスメーター	名詞
ｶﾞｳｽﾓｹｲ	ガウス模型	名詞
ｶﾞｳｽﾉﾎｳｿｸ	ガウスの法則	名詞
ｶﾞｳｽﾉｺｳｼｷ	ガウスの公式	名詞
ｶﾞｳｽﾉﾃｲﾘ	ガウスの定理	名詞
ｶﾞｳｽｻ	ガウス鎖	名詞
ｶﾞｳｽﾀﾝｲｹｲ	ガウス単位系	名詞
ｹﾞｲﾝ	ゲイン	名詞
ｹﾞｲﾘｭｻｯｸﾉﾎｳｿｸ	ゲイリュサックの法則	名詞
ｹﾞｷﾘｮｸ	撃力	名詞
ｹﾞﾝ	弦	名詞
ｹﾞﾝｶﾞｲｹﾝﾋﾞｷｮｳ	限外顕微鏡	名詞
ｹﾞﾝﾍﾝｺｳ	減偏光	名詞
ｹﾞﾝｶｲｹﾞｰｼﾞ	限界ゲージ	名詞
ｹﾞﾝｶｲﾄｳｷｭｳ	限界等級	名詞
ｹﾞﾝﾏｻﾞｲ	減摩材	名詞
ｹﾞﾝﾐﾂｶｲ	厳密解	名詞
ｹﾞﾝﾉｼﾝﾄﾞｳ	弦の振動	名詞
ｹﾞﾝｼﾊﾞﾝｺﾞｳ	原子番号	名詞
ｹﾞﾝｼﾋﾞｰﾑ	原子ビーム	名詞
ｹﾞﾝｼﾌﾞﾝｷｮｸ	原子分極	名詞
ｹﾞﾝｼﾌﾞﾂﾘｶﾞｸ	原子物理学	名詞
ｹﾞﾝｼﾄﾞｹｲ	原子時計	名詞
ｹﾞﾝｼﾊﾝｹｲ	原子半径	名詞
ｹﾞﾝｼﾊﾝﾉｳ	原子反応	名詞
ｹﾞﾝｼｶ	原子価	名詞
ｹﾞﾝｼｶｶｸ	原子価角	名詞
ｹﾞﾝｼｶｹﾂｺﾞｳﾎｳ	原子価結合法	名詞
ｹﾞﾝｼｶｸﾌﾞﾂﾘｶﾞｸ	原子核物理学	名詞
ｹﾞﾝｼｶｸｴﾈﾙｷﾞｰ	原子核エネルギー	名詞
ｶｸｴﾈﾙｷﾞｰ	核エネルギー	名詞
ｹﾞﾝｼｶｸｶﾝﾊﾟﾝ	原子核乾板	名詞
ｹﾞﾝｼｶｸｺｳｶﾞｸ	原子核工学	名詞
ｹﾞﾝｼｶｸﾆｭｳｻﾞｲ	原子核乳剤	名詞
ｹﾞﾝｼｶﾈﾂ	原子化熱	名詞
ｹﾞﾝｼｶﾝｷｮﾘ	原子間距離	名詞
ｹﾞﾝｼｶﾝﾎﾟﾃﾝｼｬﾙ	原子間ポテンシャル	名詞
ｹﾞﾝｼｶﾝﾘｮｸ	原子間力	名詞
ｹﾞﾝｼｶｾｲｷﾞｮ	原子価制御	名詞
ｹﾞﾝｼｶﾖｳﾄﾞｳ	原子価揺動	名詞
ｹﾞﾝｼｶｼﾞｮｳﾀｲ	原子価状態	名詞
ｹﾞﾝｼｹｲｺｳﾌﾞﾝｾｷ	原子蛍光分析	名詞
ｹﾞﾝｼｹｲｼﾞｮｳｲﾝｼ	原子形状因子	名詞
ｹﾞﾝｼｷﾄﾞｳ	原子軌道	名詞
ｹﾞﾝｼｷﾄﾞｳｶﾝｽｳ	原子軌道関数	名詞
ｹﾞﾝｼｺｳｿﾞｳ	原子構造	名詞
ｹﾞﾝｼｺｳｿﾞｳｲﾝｼ	原子構造因子	名詞
ｹﾞﾝｼｸｳｺｳ	原子空孔	名詞
ｹﾞﾝｼｷｭｳｺｳﾌﾞﾝｾｷ	原子吸光分析	名詞
ｹﾞﾝｼﾓｹｲ	原子模型	名詞
ｹﾞﾝｼﾈﾂ	原子熱	名詞
ｹﾞﾝｼﾛ	原子炉	名詞
ｹﾞﾝｼﾛﾝ	原子論	名詞
ｹﾞﾝｼﾛﾖｳｷ	原子炉容器	名詞
ｹﾞﾝｼﾘｮｸﾃﾞﾝﾁ	原子力電池	名詞
ｹﾞﾝｼｻﾝﾗﾝｲﾝｼ	原子散乱因子	名詞
ｹﾞﾝｼｾｲ	原始星	名詞
ｹﾞﾝｼｾﾝ	原子線	名詞
ｹﾞﾝｼｾﾝｻﾝﾗﾝ	原子線散乱	名詞
ｹﾞﾝｼｾﾝｼﾞｷｷｮｳﾒｲ	原子線磁気共鳴	名詞
ｹﾞﾝｼｼﾝ	原子心	名詞
ｹﾞﾝｼｼﾝﾌﾞﾝｷｮｸ	原子心分極	名詞
ｹﾞﾝｼｼﾂﾘｮｳ	原子質量	名詞
ｹﾞﾝｼｼﾂﾘｮｳｺｳｼｷ	原子質量公式	名詞
ｹﾞﾝｼｼﾂﾘｮｳﾀﾝｲ	原子質量単位	名詞
ｹﾞﾝｼｽﾍﾟｸﾄﾙ	原子スペクトル	名詞
ｹﾞﾝｼｼｮｳﾄﾂ	原子衝突	名詞
ｹﾞﾝｼｼｭｳﾊｽｳ	原子周波数	名詞
ｹﾞﾝｼﾀｲｾｷ	原子体積	名詞
ｹﾞﾝｼﾀｲﾖｳ	原始太陽	名詞
ｹﾞﾝｼﾀｲﾖｳｹｲｾｲｳﾝ	原始太陽系星雲	名詞
ｹﾞﾝｼﾀﾝｲｹｲ	原子単位系	名詞
ｹﾞﾝｼﾖｳ	原子容	名詞
ｹﾞﾝｼｼﾞ	原子時	名詞
ｹﾞﾝｿﾌﾞﾝｾｷ	元素分析	名詞
ｹﾞﾝｿﾊﾝﾄﾞｳﾀｲ	元素半導体	名詞
ｹﾞﾝｿｷｺﾞｳ	元素記号	名詞
ｹﾞﾝｿｸｷｮﾘ	減速距離	名詞
ｹﾞﾝｿｸﾐﾂﾄﾞ	減速密度	名詞
ｹﾞﾝｿｸｻﾞｲ	減速材	名詞
ｹﾞﾝｽｲﾊ	減衰波	名詞
ｹﾞﾝｽｲﾋｽﾞﾐ	減衰ひずみ	名詞
ｹﾞﾝｽｲｹｲｽｳ	減衰係数	名詞
ｹﾞﾝｽｲｷ	減衰器	名詞
ｹﾞﾝｽｲｷｮﾘ	減衰距離	名詞
ｹﾞﾝｽｲﾘｮｸ	減衰力	名詞
ｹﾞﾝｽｲｼﾝﾄﾞｳ	減衰振動	名詞
ｹﾞﾝｽｲﾃｲｽｳ	減衰定数	名詞
ｹﾞﾝｽｲｾﾞﾝﾊﾝｼｬ	減衰全反射	名詞
ｹﾞﾝｽｲｼﾞﾃｲｽｳ	減衰時定数	名詞
ｹﾞﾝｻﾞﾝｶｲﾛ	減算回路	名詞
ｹﾞﾝｼﾞ	減磁	名詞
ｹﾞﾙﾏﾆｳﾑﾀﾞｲｵｰﾄﾞ	ゲルマニウムダイオード	名詞
ｹﾞﾙﾏﾝﾛｰﾉｶﾝｹｲｼｷ	ゲルマン・ローの関係式	名詞
ｹﾞﾙｼﾝﾄｳ	ゲル浸透	名詞
ｸﾛﾏﾄｸﾞﾗﾌｨｰ	クロマトグラフィー	名詞
ｹﾞｰﾄﾊﾞﾙﾌﾞ	ゲートバルブ	名詞
ｹﾞｰﾄｶｲﾛ	ゲート回路	名詞
ｹﾞｯﾀｰﾎﾟﾝﾌﾟ	ゲッターポンプ	名詞
ｹﾞｯﾀﾘﾝｸﾞ	ゲッタリング	名詞
ｹﾞｰｼﾞﾍﾝｶﾝ	ゲージ変換	名詞
ｹﾞｰｼﾞﾌﾍﾝｾｲ	ゲージ不変性	名詞
ｹﾞｰｼﾞｺﾃｲ	ゲージ固定	名詞
ｹﾞｰｼﾞﾘﾛﾝ	ゲージ理論	名詞
ｹﾞｰｼﾞﾘｭｳｼ	ゲージ粒子	名詞
ｷﾞﾍﾞｸﾄﾙ	擬ベクトル	名詞
ｷﾞﾌﾞｽﾃﾞｭｴﾑﾉｶﾝｹｲ	ギブス・デュエムの関係	名詞
ｷﾞﾌﾞｽﾍﾙﾑﾎﾙﾂﾉｼｷ	ギブス・ヘルムホルツの式	名詞
ｷﾞﾌﾞｽﾉｿｳﾘﾂ	ギブスの相律	名詞
ｷﾞﾌﾞｽﾉｼﾞﾕｳｴﾈﾙｷﾞｰ	ギブスの自由エネルギー	名詞
ｷﾞﾌﾞｽｼｭｳｺﾞｳ	ギブス集合	名詞
ｷﾞﾀﾞﾝｾｲ	擬弾性	名詞
ｷﾞｴﾊﾞｰﾄﾝﾈﾙｺｳｶ	ギエバートンネル効果	名詞
ｷﾞｴﾈﾙｷﾞｰｷﾞｬｯﾌﾟ	擬エネルギーギャップ	名詞
ｷﾞﾌｫｰﾄﾞﾏｸﾏﾎﾝｻｲｸﾙ	ギフォード・マクマホンサイクル	名詞
ｷﾞｺｳｻ	擬交差	名詞
ｷﾞｺｳｿﾞｳﾌﾍﾝﾘｮｳ	擬構造不変量	名詞
ﾌﾍﾝﾘｮｳ	不変量	名詞
ｷﾞﾝｶﾞﾀﾞﾝ	銀河団	名詞
ｷﾞﾝｶﾞﾃﾞﾝﾊﾟ	銀河電波	名詞
ｷﾞﾝｶﾞﾊｲｹｲﾎｳｼｬ	銀河背景放射	名詞
ｷﾞﾝｶﾞｶｲﾃﾝ	銀河回転	名詞
ｷﾞﾝｶﾞｶﾝｸｳｶﾝ	銀河間空間	名詞
ｷﾞﾝｶﾞｹｲｶﾞｲｾｲｳﾝ	銀河系外星雲	名詞
ｷﾞﾝｶﾞﾒﾝ	銀河面	名詞
ｷﾞﾝｶﾞｾｲﾀﾞﾝ	銀河星団	名詞
ｷﾞﾝｶﾞｳﾁｭｳｾﾝ	銀河宇宙線	名詞
ｷﾞﾝｶﾞｻﾞﾋｮｳ	銀河座標	名詞
ｷﾞﾝｶﾞｻﾞﾂｵﾝ	銀河雑音	名詞
ｷﾞﾝｲ	銀緯	名詞
ｷﾞﾆｴ	ギニエ	人名
ｷﾞﾆｴ	Guinier	人名
ｷﾞﾆｴｶﾒﾗ	ギニエカメラ	名詞
ｷﾞﾆｴﾌﾟﾚｽﾄﾝﾀｲ	ギニエ・プレストン帯	名詞
ｷﾞﾆｴｻｸｽﾞ	ギニエ作図	名詞
ｷﾞﾝｹｲ	銀経	名詞
ｷﾞﾝｽﾞﾌﾞﾙｸﾞﾗﾝﾀﾞｳ	ギンズブルグ・ランダウ	人名
ｷﾞﾎﾟﾃﾝｼｬﾙ	擬ポテンシャル	名詞
ｷﾞﾙﾊﾞｰﾄ	ギルバート	名詞
ｷﾞﾙﾏﾝｼﾞｮﾝｽﾄﾝｷｺｳ	ギルマン・ジョンストン機構	名詞
ｷﾞｾﾝ	偽線	名詞
ｷﾞｿｳｷｮｸｼｿｳｺﾞｻﾖｳ	偽双極子相互作用	名詞
ｷﾞｽｶﾗｰ	擬スカラー	名詞
ｷﾞｽｶﾗｰﾁｭｳｶﾝｼ	擬スカラー中間子	名詞
ｷﾞﾃﾝｿﾙ	擬テンソル	名詞
ｷﾞｼﾞﾊ	擬似波	名詞
ｷﾞｼﾞﾌｶ	擬似負荷	名詞
ｷﾞｼﾞﾎﾟﾃﾝｼｬﾙ	擬似ポテンシャル	名詞
ｷﾞｼﾞﾗﾋﾟﾃﾞｨﾃｨ	擬似ラピディティ	名詞
ｷﾞｼﾞｮｳﾀｲ	擬状態	名詞
ｺﾞﾍﾝｲｾｲ	互変異性	名詞
ｺﾞｳｷﾝｶｸｻﾝ	合金拡散	名詞
ｺﾞｳｷﾝｹｲ	合金系	名詞
ﾁｮｳﾃﾞﾝﾄﾞｳｻﾞｲﾘｮｳ	超伝導材料	名詞
ｺﾞｳｷﾝｾﾂｺﾞｳ	合金接合	名詞
ｺﾞｷｮｸｶﾝ	五極管	名詞
ｺﾞﾑﾀﾞﾝｾｲ	ゴム弾性	名詞
ｺﾞﾑｼﾞｮｳﾀｲ	ゴム状態	名詞
ｺﾞﾆｵﾒｰﾀｰ	ゴニオメーター	名詞
ｺﾞﾚｰｾﾙ	ゴレーセル	名詞
ｺﾞｰﾙﾄﾞﾎﾞﾝﾄﾞ	ゴールドボンド	名詞
ｺﾞｰﾙﾄﾞｽﾄｰﾝ	ゴールドストーン	人名
ｺﾞｰﾙﾄﾞｽﾄｰﾝ	Goldstone	人名
ｺﾞｰﾙﾄﾞｽﾄｰﾝﾎﾞｿﾝ	ゴールドストーンボソン	名詞
ｺﾞｰﾙﾄﾞｽﾄｰﾝﾉﾓｰﾄﾞ	ゴールドストーンのモード	名詞
ｺﾞﾙｽｷｰｺｳｶ	ゴルスキー効果	名詞
ｺﾞｳﾘｭｳﾋﾞｰﾑﾎｳ	合流ビーム法	名詞
ｺﾞｻﾃﾞﾝﾊﾟﾉﾎｳｿｸ	誤差伝播の法則	名詞
ｺﾞｻｶｲｾｷ	誤差解析	名詞
ｺﾞｻﾛﾝ	誤差論	名詞
ｺﾞｳｾｲﾊ	合成波	名詞
ｺﾞｳｾｲﾘﾂ	剛性率	名詞
ｺﾞｳｾｲｼﾝﾄﾞｳ	合成振動	名詞
ｺﾞｳｾｲﾃｲｺｳ	合成抵抗	名詞
ｺﾞｳｾｲｼﾞｭｼ	合成樹脂	名詞
ｺﾞｳｿｾｲﾀｲ	剛塑性体	名詞
ｺﾞｰｽﾄﾂﾌﾞｼ	ゴーストつぶし	名詞
ｺﾞｳﾀｲﾌﾘｺ	剛体振り子	名詞
ｺﾞｳﾀｲｷｭｳ	剛体球	名詞
ｺﾞｳﾀｲｷｭｳｷﾀｲﾓｹｲ	剛体球気体模型	名詞
ｺﾞｳﾀｲﾉﾂﾘｱｲ	剛体の釣合い	名詞
ｺﾞｼﾞｭｳｺｳ	五重項	名詞
ｺﾞｼﾞｭｳｺｳｼﾞｮｳﾀｲ	五重項状態	名詞
ｺﾞｼﾞｭｳｾﾝ	五重線	名詞
ｸﾞｳﾃﾞﾝｼｼﾞｮｳﾀｲ	偶電子状態	名詞
ｸﾞｳｸﾞｳｶｸ	偶偶核	名詞
ｸﾞｳｷｶｸ	偶奇核	名詞
ｸﾞｳｷｺｳｶ	偶奇効果	名詞
ｸﾞｳｷｾｲ	偶奇性	名詞
ｸﾞｳｺｳ	偶項	名詞
ｸﾞﾝｸｯｾﾂﾘﾂ	群屈折率	名詞
ｸﾞﾝｿｸﾄﾞ	群速度	名詞
ｸﾞﾌﾟﾀﾌﾞﾛｲﾗｰｹｲｼｷ	グプタ・ブロイラー形式	名詞
ｸﾞﾌﾟﾀﾉｼﾞｮｳｹﾝ	グプタの条件	名詞
ｸﾞﾗﾋﾞﾄﾝ	グラビトン	名詞
ｸﾞﾗﾃﾞｨｴﾝﾄ	グラディエント	名詞
ｸﾞﾗｰﾄﾞ	ｸﾞﾗｰﾄﾞ	名詞
ｸﾞﾗﾌｧｲﾄｺｳｿﾞｳ	グラファイト構造	名詞
ｸﾞﾗﾌｧｲﾄ	グラファイト	名詞
ｿｳｶﾝｶｺﾞｳﾌﾞﾂ	層間化合物	名詞
ｸﾞﾗﾑﾌﾞﾝｼ	グラム分子	名詞
ｸﾞﾗﾑｹﾞﾝｼ	グラム原子	名詞
ｸﾞﾗﾑﾄｳﾘｮｳ	グラム当量	名詞
ｸﾞﾗﾑｼﾞｭｳ	グラム重	名詞
ｸﾞﾗﾅﾄﾘｭｯｹﾘﾛﾝ	グラナト・リュッケ理論	名詞
ｸﾞﾗﾝﾌｰｺｰﾌﾟﾘｽﾞﾑ	グラン・フーコープリズム	名詞
ｸﾞﾗﾝﾄﾑｿﾝﾌﾟﾘｽﾞﾑ	グラン・トムソンプリズム	名詞
ｸﾞﾗｽﾎﾌｽｳ	グラスホフ数	名詞
ｸﾞﾗｳﾊﾞｰﾘﾛﾝ	グラウバー理論	名詞
ｸﾞﾗｳﾝﾄﾞｼｬｲﾝ	グラウンドシャイン	名詞
ｸﾞﾚｱﾑﾉﾎｳｿｸ	グレアムの法則	名詞
ｸﾞﾚｲﾌﾞﾗｯｸﾞ	グレイ・ブラッグ	人名
ｸﾞﾚｲ	グレイ	名詞
ｸﾞﾚｰﾝ	グレーン	名詞
ｸﾞﾘｯﾄﾞ	グリッド	名詞
ｸﾞﾘｯﾄﾞﾃｲｺｳ	グリッド抵抗	名詞
ｸﾞﾘﾌｨｽﾌﾄｳｼｷ	グリフィス不等式	名詞
ｸﾞﾘﾌｨｽｷﾚﾂ	グリフィス亀裂	名詞
ｸﾞﾘｰﾝｶﾝｽｳ	グリーン関数	名詞
ｸﾞﾘｰﾝｶﾝｽｳﾎｳ	グリーン関数法	名詞
ｸﾞﾘﾆｼﾞﾍｲｷﾝｼﾞ	グリニジ平均時	名詞
ｸﾞﾘﾆｼﾞｼｺﾞｾﾝ	グリニジ子午線	名詞
ｸﾞﾘﾙﾌﾞﾝｺｳｷ	グリル分光器	名詞
ｸﾞﾛｰﾊﾞｰ	グローバー	名詞
ｸﾞﾛｰﾌﾞﾎﾞｯｸｽ	グローブボックス	名詞
ｸﾞﾛｰﾎｳﾃﾞﾝ	グロー放電	名詞
ｸﾞﾛｰﾘｻﾝﾗﾝ	グローリ散乱	名詞
ｸﾞﾛﾄﾘｱﾝｽﾞ	グロトリアン図	名詞
ｸﾞﾙｰｵﾝ	グルーオン	名詞
ｸﾞｳﾘｮｸ	偶力	名詞
ﾘｷﾂｲ	力対	名詞
ｸﾞｳﾘｮｸﾉﾓｰﾒﾝﾄ	偶力のモーメント	名詞
ｸﾞﾘｭｰﾅｲｾﾞﾝﾉｶﾝｹｲ	グリューナイゼンの関係	名詞
ｸﾞﾘｭｰﾅｲｾﾞﾝﾉﾃｲｽｳ	グリューナイゼンの定数	名詞
ｸﾞｳｾﾞﾝｺﾞｻ	偶然誤差	名詞
ｸﾞｳｾﾞﾝｾｲ	偶然性	名詞
ｸﾞｳｾﾞﾝﾃｷ	偶然的	名詞
ｷﾞｬｸﾀﾞｲｵｰﾄﾞ	逆ダイオード	名詞
ｷﾞｬｸﾃﾞﾝｱﾂ	逆電圧	名詞
ｷﾞｬｸﾎﾀﾙｲｼｶﾞﾀ	逆蛍石型	名詞
ｷﾞｬｸｲｿｳｷｮｳｶｲ	逆位相境界	名詞
ｷﾞｬｸｲｿｳﾘｮｳｲｷ	逆位相領域	名詞
ｷﾞｬｸｶｲﾛ	逆回路	名詞
ｷﾞｬｸｶｸｻﾝ	逆拡散	名詞
ｷﾞｬｸｷﾃﾞﾝｱﾂ	逆起電圧	名詞
ｷﾞｬｸｷﾃﾞﾝﾘｮｸ	逆起電力	名詞
ｷﾞｬｸｺ	逆弧	名詞
ｷﾞｬｸｺﾝﾌﾟﾄﾝｺｳｶ	逆コンプトン効果	名詞
ｷﾞｬｸｺｳｼ	逆格子	名詞
ｷﾞｬｸｺｳｼｸｳｶﾝ	逆格子空間	名詞
ｷﾞｬｸﾓﾝﾀﾞｲ	逆問題	名詞
ｷﾞｬｸﾆｼﾞｮｳﾎｳｿｸ	逆二乗法則	名詞
ｷﾞｬｸﾆｼﾞｮｳﾉﾎｳｿｸ	逆二乗の法則	名詞
ｷﾞｬｸﾗﾏﾝﾌﾞﾝｺｳﾎｳ	逆ラマン分光法	名詞
ｷﾞｬｸﾗﾏﾝｺｳｶ	逆ラマン効果	名詞
ｷﾞｬｸｻﾝﾗﾝﾎｳ	逆散乱法	名詞
ｷﾞｬｸｾｲﾄﾞｳﾎｳｼｬ	逆制動放射	名詞
ｷﾞｬｸｾﾝﾌﾞﾝｻﾝ	逆線分散	名詞
ｷﾞｬｸｼﾝﾄｳ	逆浸透	名詞
ｷﾞｬｸｽﾋﾟﾈﾙｶﾞﾀ	逆スピネル型	名詞
ｷﾞｬｸﾀｲﾃﾞﾝｱﾂ	逆耐電圧	名詞
ｷﾞｬｸﾃﾝｺｳ	逆転項	名詞
ｷﾞｬｸﾃﾝｵﾝﾄﾞ	逆転温度	名詞
ｷﾞｬｸﾃﾝｿｳ	逆転層	名詞
ｷﾞｬｸﾃﾝﾀｼﾞｭｳｺｳ	逆転多重項	名詞
ｷﾞｬｸﾃﾝｼﾞﾊﾞﾋﾟﾝﾁ	逆転磁場ピンチ	名詞
ｷﾞｬｸﾄｹｲﾏﾜﾘ	逆時計回り	名詞
ｷﾞｬｸXｾﾝｺｳｶ	逆X線効果	名詞
ｷﾞｬｸｾﾞﾝｷｶｲﾘ	逆前期解離	名詞
ｷﾞｬｯﾌﾟﾓｰﾄﾞ	ギャップモード	名詞
ｷﾞｮｳｹﾂｶｸ	凝結核	名詞
ｷﾞｮｳｺﾈﾂ	凝固熱	名詞
ｷﾞｮｳｺﾃﾝｺｳｶ	凝固点降下	名詞
ｷﾞｮｳﾚﾂﾘｷｶﾞｸ	行列力学	名詞
ｷﾞｮｳﾚﾂﾖｳｿ	行列要素	名詞
ｷﾞｮｳｼｭｳｴﾈﾙｷﾞｰ	凝集エネルギー	名詞
ｷﾞｮｳｼｭｸｶｸﾘﾂ	凝縮確率	名詞
ｷﾞｮｳｼｭｸｹｲｽｳ	凝縮係数	名詞
ｷﾞｮｳｼｭｸｷ	凝縮器	名詞
ｷﾞｮｳｼｭｸﾏｸ	凝縮膜	名詞
ｷﾞｮｳｼｭｸﾈﾂ	凝縮熱	名詞
ｷﾞｮｳｼｭｸﾀｲ	凝縮体	名詞
ｷﾞｮｳｼｭｳﾘｮｸ	凝集力	名詞
ｷﾞｮｳﾚﾂｼｷ	行列式	名詞
ﾋﾘｮｳｲｷ	HI領域	名詞
HRｽﾞ	HR図	名詞
Hﾃｲﾘ	H定理	名詞
ﾊﾊﾞｰﾄﾞﾓｹｲ	ハバード模型	名詞
ﾊｯﾌﾞﾙﾉﾎｳｿｸ	ハッブルの法則	名詞
ﾊﾀﾞｶﾉｼﾂﾘｮｳ	裸の質量	名詞
ﾊﾄﾞｳﾍﾞｸﾄﾙ	波動ベクトル	名詞
ﾊﾄﾞｳｴﾝｻﾞﾝｼ	波動演算子	名詞
ﾊﾄﾞｳﾎｳﾃｲｼｷ	波動方程式	名詞
ﾊﾄﾞｳｲﾝﾋﾟｰﾀﾞﾝｽ	波動インピーダンス	名詞
ﾊﾄﾞｳｶﾝｽｳ	波動関数	名詞
ﾊﾄﾞｳｶﾝｽｳﾉｸﾘｺﾐ	波動関数のくりこみ	名詞
ﾊｰﾄﾞｺｱ	ハードコア	名詞
ﾊｰﾄﾞｺｱﾋﾟﾝﾁ	ハードコアピンチ	名詞
ﾊﾄﾞｳｺｳｶﾞｸ	波動光学	名詞
ﾊﾄﾞｳﾘｷｶﾞｸ	波動力学	名詞
ﾊﾄﾞﾛﾝ	ハドロン	名詞
ﾊﾄﾞｳﾃｲｺｳ	波動抵抗	名詞
ﾊｰｹﾞﾝﾎﾞｱｽﾞｲﾕ	ハーゲン・ボアズイユ	名詞
ﾊｰｹﾞﾝﾙｰﾍﾞﾝｽﾉｼｷ	ハーゲン・ルーベンスの式	名詞
ﾊｰｸﾞﾉﾃｲﾘ	ハーグの定理	名詞
ﾊｲｱﾂ	背圧	名詞
ﾊｲｲ	配位	名詞
ﾊｲｲｴﾝﾄﾛﾋﾟｰ	配位エントロピー	名詞
ﾊｲｲｹﾂｺﾞｳ	配位結合	名詞
ﾊｲｲｺﾝｺﾞｳ	配位混合	名詞
ﾊｲｲｸｳｶﾝ	配位空間	名詞
ﾊｲｲｼ	配位子	名詞
ﾊｲｲｼﾊﾞ	配位子場	名詞
ﾊｲｲｽｳ	配位数	名詞
ﾊｲｷｿｸﾄﾞ	排気速度	名詞
ﾊｲｺｳ	配向	名詞
ﾊｲｺｳﾌﾞﾝｷｮｸ	配向分極	名詞
ﾊｲｺｳﾄﾞｹﾞﾝｼｮｳ	配向度減少	名詞
ﾊｲｺｳﾄﾞﾉｹﾞﾝｼｮｳ	配向度の減少	名詞
ﾊｲｺｳﾀｲｼｮｳｾｲ	配向対称性	名詞
ﾊｲｺｳﾁﾂｼﾞｮ	配向秩序	名詞
ﾊｲﾊﾟｰﾌﾗｸﾞﾒﾝﾄ	ハイパーフラグメント	名詞
ﾊｲﾊﾟｰｶｸ	ハイパー核	名詞
ﾊｲﾊﾟｰﾗﾏﾝｻﾝﾗﾝ	ハイパーラマン散乱	名詞
ﾊｲﾊﾟｰﾁｬﾈﾘﾝｸﾞ	ハイパーチャネリング	名詞
ﾊｲﾊﾟｰﾁｬｰｼﾞ	ハイパーチャージ	名詞
ﾊｲﾍﾟﾛﾝ	ハイペロン	名詞
ﾊｲﾀｹﾞﾝﾘ	排他原理	名詞
ﾊｲﾀﾘﾂ	排他律	名詞
ﾊｲﾁｶﾝｿｳｺﾞｻﾖｳ	配置間相互作用	名詞
ﾊｲﾁｺﾝｺﾞｳ	配置混合	名詞
ﾊｲﾁｸｳｶﾝ	配置空間	名詞
ﾊｲﾄﾗｰﾛﾝﾄﾞﾝｶﾞﾀ	ハイトラー・ロンドン型	名詞
ﾊｲﾄﾗｰﾛﾝﾄﾞﾝﾉﾘﾛﾝ	ハイトラー・ロンドンの理論	名詞
ﾊｲｾﾞﾝﾍﾞﾙｸﾞ	ハイゼンベルグ	人名
ﾊｲｾﾞﾝﾍﾞﾙｸﾞ	Heisenberg	人名
ﾊｲｾﾞﾝﾍﾞﾙｸﾞﾋｮｳｼﾞ	ハイゼンベルグ表示	名詞
ﾊｲｾﾞﾝﾍﾞﾙｸﾞﾓｹｲ	ハイゼンベルグ模型	名詞
ﾌｶｸﾃｲｾｲｹﾞﾝﾘ	不確定性原理	名詞
ｳﾝﾄﾞｳﾎｳﾃｲｼｷ	運動方程式	名詞
ﾊｲｾﾞﾝﾍﾞﾙｸﾞﾊﾟｳﾘ	ハイゼンベルグ・パウリ	人名
ﾊｲｾﾞﾝﾍﾞﾙｸﾞﾘｮｸ	ハイゼンベルグ力	名詞
ﾊｲｼﾞｮﾀｲｾｷｺｳｶ	排除体積効果	名詞
ﾊｶｲﾃﾞﾝｱﾂ	破壊電圧	名詞
ﾊｶｲｵｳﾘｮｸ	破壊応力	名詞
ﾊｶｲﾘｷｶﾞｸ	破壊力学	名詞
ﾊｶｲﾃｷﾌｱﾝﾃｲｾｲ	破壊的不安定性	名詞
ﾊｶｲｼﾞﾝｾｲ	破壊靱性	名詞
ﾊｰｶｰｶｽﾊﾟｰﾉﾌﾄｳｼｷ	ハーカー・カスパーの不等式	名詞
ﾊｹｲｶｲｾｷ	波形解析	名詞
ﾊｹｲﾘﾂ	波形率	名詞
ﾊｯｷﾝﾃｲｺｳｵﾝﾄﾞｹｲ	白金抵抗温度計	名詞
ﾊｯｺｳﾊﾞﾝﾄﾞ	発光バンド	名詞
ﾊｯｺｳﾀﾞｲｵｰﾄﾞ	発光ダイオード	名詞
ﾊｯｺｳｿｼ	発光素子	名詞
ﾊｯｺｳｽﾍﾟｸﾄﾙ	発光スペクトル	名詞
ﾊｯｺｳﾁｭｳｼﾝ	発光中心	名詞
ﾊｯｷｮｸ	八極	連体詞
ﾊｺｳﾌﾞﾝｾｷｷ	波高分析器	名詞
ﾊｺｳﾘﾂ	波高率	名詞
ﾊｺｼｷｷｶｸｶ	箱式規格化	名詞
ﾊｸｹﾝﾃﾞﾝｷ	はく検電器	名詞
ﾊｸｹﾝﾃﾞﾝｷ	箔検電器	名詞
ﾊｸﾏｸﾄﾗﾝｼﾞｽﾀｰ	薄膜トランジスター	名詞
ﾊｸﾒｲｼ	薄明視	名詞
ﾊｸﾈﾂﾃﾞﾝｷｭｳ	白熱電球	名詞
ﾊｸｼｮｸﾁｭｳｾｲｼｶｲｾﾂ	白色中性子回折	名詞
ﾊｸｼｮｸﾜｲｾｲ	白色わい星	名詞
ﾊｸｼｮｸﾜｲｾｲ	白色矮星	名詞
ﾊｸｼｮｸXｾﾝ	白色X線	名詞
ﾊｸｼｮｸｻﾞﾂｵﾝ	白色雑音	名詞
ﾊﾒﾝﾌﾞﾝｶﾂ	波面分割	名詞
ﾊﾒﾝｻｲｾｲ	波面再生	名詞
ﾊﾒﾝｼｭｳｻ	波面収差	名詞
ﾊﾐﾙﾄﾝ	ハミルトン	人名
ﾊﾐﾙﾄﾝ	Hamilton	人名
ﾊﾐﾙﾄﾝｴﾝｻﾞﾝｼ	ハミルトン演算子	名詞
ﾊﾐﾙﾄﾆｱﾝ	ハミルトニアン	名詞
ﾊﾐﾙﾄﾝﾉｹﾞﾝﾘ	ハミルトンの原理	名詞
ｾｲｼﾞｭﾝｳﾝﾄﾞｳ	正準運動	名詞
ﾊﾐﾙﾄﾝﾔｺﾋﾞﾉﾎｳﾃｲｼｷ	ハミルトン・ヤコビの方程式	名詞
ﾊﾐﾙﾄﾝｻﾞｶﾘｱｰｾﾞﾝ	ハミルトン・ザカリアーゼン	人名
ﾊﾑｺｳｶ	ハム効果	名詞
ﾊﾝﾌﾞｯｼﾂ	反物質	名詞
ﾊﾝﾄﾞｳﾀｲﾃﾞﾝｷｮｸ	半導体電極	名詞
ﾊﾝﾄﾞｳﾀｲｹﾝｼｭﾂｷ	半導体検出器	名詞
ﾊﾝﾄﾞｳﾀｲｷﾝｿﾞｸ	半導体-金属	名詞
ﾊﾝﾄﾞｳﾀｲｷｵｸｿｼ	半導体記憶素子	名詞
ﾊﾝﾄﾞｳﾀｲﾚｰｻﾞｰ	半導体レーザー	名詞
ﾊﾝﾄﾞｳﾀｲｾｲﾘｭｳｷ	半導体整流器	名詞
ﾊﾝﾄﾞｳﾀｲｾﾂｺﾞｳ	半導体接合	名詞
ﾊﾝﾄﾞｳﾀｲｿｼ	半導体素子	名詞
ﾊﾝﾄﾞｳｼﾞｶｲﾛ	反同時回路	名詞
ﾊﾝﾄﾞｳｼﾞｹｲｽｳｶｲﾛ	反同時計数回路	名詞
ﾊﾝｴｲﾎｳ	半影法	名詞
ﾊﾈｶｴﾘｹｲｽｳ	はね返り係数	名詞
ﾊﾈﾐｽﾞ	はね水	名詞
ﾊﾝｸﾞﾝ	半群	名詞
ﾊﾝﾊﾊﾞ	半幅	名詞
ﾊﾝﾊﾁｮｳﾊﾞﾝ	半波長板	名詞
ﾊﾝﾍﾝ	半変	名詞
ﾊﾝｲｿｳｷｮｲｳｶｲ	反位相境界	名詞
ﾊﾝｲｿｳﾘｮｳｲｷ	反位相領域	名詞
ﾊﾝｶｸｼ	反核子	名詞
ﾊﾝｶﾝｽｳ	汎関数	名詞
ﾊﾝｶﾝｽｳﾋﾞﾌﾞﾝ	汎関数微分	名詞
ﾊﾝｶｿｳ	半価層	名詞
ﾊﾝｹｲｹﾝﾃｷ	半経験的	名詞
ﾊﾝｹﾂｺﾞｳｷﾄﾞｳ	反結合軌道	名詞
ﾊﾝｷﾝｿﾞｸ	半金属	名詞
ﾊﾝｺｳｶﾝｶﾝｹｲ	反交換関係	名詞
ﾊﾝｺｳｶﾝｼ	反交換子	名詞
ﾊﾝｺﾃﾝﾛﾝ	半古典論	名詞
ﾊﾝｷｮｳｼﾝ	反共振	名詞
ﾊﾝｷｮｳﾕｳﾃﾞﾝﾀｲ	反強誘電体	名詞
ﾊﾝｷｮｳﾕｳﾃﾞﾝｾｲ	反強誘電性	名詞
ﾊﾝｷｮｳｼﾞｾｲ	反強磁性	名詞
ﾊﾝｷｮｳｼﾞｾｲｷｮｳﾒｲ	反強磁性共鳴	名詞
ﾊﾝｷｮｳｼﾞｾｲﾀｲ	反強磁性体	名詞
ﾊﾝﾒﾝｿﾞｳ	半面像	名詞
ﾊﾝﾉｳﾀﾞﾝﾒﾝｾｷ	反応断面積	名詞
ﾊﾝﾉｳｹｲﾛ	反応経路	名詞
ﾊﾝﾉｳﾈﾂ	反応熱	名詞
ﾊﾝﾉｳｾｲｾｲﾌﾞﾂ	反応生成物	名詞
ﾊﾝﾉｳｿｸﾄﾞ	反応速度	名詞
ｿｸﾄﾞﾎｳﾃｲｼｷ	速度方程式	名詞
ﾊﾝﾉｳｿｸﾄﾞﾎｳﾃｲｼｷ	反応速度方程式	名詞
ｿｸﾄﾞﾃｲｽｳ	速度定数	名詞
ﾊﾝﾉｳｿｸﾄﾞﾃｲｽｳ	反応速度定数	名詞
ﾊﾝﾉｳｼｮｳﾄﾂ	反応衝突	名詞
ﾊﾝﾉｳｼﾞｶﾝ	反応時間	名詞
ﾊﾝﾆｭｰﾄﾘﾉ	反ニュートリノ	名詞
ﾊﾝﾊﾟﾃﾞﾝｲ	半波電位	名詞
ﾊﾝﾊﾟｾｲﾘｭｳ	半波整流	名詞
ﾊﾝﾊﾟﾂｹｲｽｳ	反発係数	名詞
ﾊﾝﾍﾟﾝﾍﾞｸﾄﾙ	反変ベクトル	名詞
ﾊﾝﾌﾟｸﾎｳ	反復法	名詞
ﾊﾝﾙｺｳｶ	ハンル効果	名詞
ﾊﾝﾘｭｳ	伴流	名詞
ﾊﾝﾘｭｳｼ	反粒子	名詞
ﾊﾝｾｲｽｳｷｮｳﾒｲ	半整数共鳴	名詞
ﾊﾝｾﾝｹｲ	反線形	連体詞
ﾊﾝｽﾄｰｸｽｾﾝ	反ストークス線	名詞
ﾊﾝｼｬﾎﾞｳｼﾏｸ	反射防止膜	名詞
ﾊﾝｼｬﾃﾞﾝｼｾﾝｶｲｾﾂ	反射電子線回折	名詞
ﾊﾝｼｬｶﾞﾀｶｲｾﾂｺｳｼ	反射型回折格子	名詞
ﾊﾝｼｬｶﾞﾀｸﾗｲｽﾄﾛﾝ	反射型クライストロン	名詞
ﾊﾝｼｬﾊ	反射波	名詞
ﾊﾝｼｬｶｸ	反射角	名詞
ﾊﾝｼｬｹｲｽｳ	反射係数	名詞
ﾊﾝｼｬｺｳｿｸﾃﾞﾝｼｶｲｾﾂ	反射高速電子回折	名詞
ﾊﾝｼｬｷｮｸｾﾝ	反射曲線	名詞
ﾊﾝｼｬｷｭｳ	反射球	名詞
ﾊﾝｼｬｾｲｳﾝ	反射星雲	名詞
ﾊﾝｼｬｾﾝﾊﾊﾞ	反射線幅	名詞
ﾊﾝｼｬｽﾍﾟｸﾄﾙ	反射スペクトル	名詞
ﾊﾝｼｬﾀｲ	反射体	名詞
ﾊﾝｼｬｿﾞｳｶﾏｸ	反射増加膜	名詞
ﾊﾝｼｮｳ	斑晶	名詞
ﾊﾝﾀｲｼｮｳ	反対称	名詞
ﾊﾝﾀｲｼｮｳ	反対称	連体詞
ﾊﾝﾀｲｼｮｳｶｲﾃﾝｼﾞｭﾝｲ	反対称回転準位	名詞
ｺｳｶﾝｿｳｺﾞｻﾖｳ	交換相互作用	名詞
ﾊﾝﾀｲｼｮｳｸｳｶﾝ	反対称空間	名詞
ﾊﾝﾀﾝｼﾞｭﾝ	半単純	連体詞
ﾊﾝﾃﾝﾌﾞﾝﾌﾟ	反転分布	名詞
ﾊﾝﾃﾝｶﾃｲ	反転過程	名詞
ﾊﾝﾃﾝﾆｼﾞｭｳｺｳ	反転二重項	名詞
ﾊﾝﾃﾝｵﾝﾄﾞ	反転温度	名詞
ﾊﾝﾃﾝﾗﾏﾝﾌﾞﾝｺｳﾎｳ	反転ラマン分光法	名詞
ﾊﾝﾃﾝﾗﾏﾝｺｳｶ	反転ラマン効果	名詞
ﾊﾝﾃﾝﾗﾑﾃﾞｨｯﾌﾟ	反転ラムディップ	名詞
ﾊﾝﾃﾝｿｳ	反転層	名詞
ﾊﾝﾃﾝｽﾍﾟｸﾄﾙ	反転スペクトル	名詞
ﾊﾝﾁﾊﾊﾞ	半値幅	名詞
ﾊﾝﾁｼﾝﾄﾞ	半値深度	名詞
ﾊﾝﾁｾﾞﾝﾊﾊﾞ	半値全幅	名詞
ﾊﾝﾄｳｷｮｳ	半透鏡	名詞
ﾊﾝﾄｳﾏｸ	半透膜	名詞
ﾊﾝﾄｳﾒｲｷｮｳ	半透明鏡	名詞
ﾊﾝﾄｳﾒｲﾀｲ	半透明体	名詞
ﾊﾝﾁｮｳ	反跳	名詞
ﾊﾝﾁｮｳﾃﾞﾝｼ	反跳電子	名詞
ﾊﾝﾁｮｳｴﾈﾙｷﾞｰ	反跳エネルギー	名詞
ﾊﾝﾁｮｳｹﾞﾝｼ	反跳原子	名詞
ﾊﾝﾁｮｳｶｸｳﾒｺﾐﾎｳ	反跳核埋込法	名詞
ﾊﾝﾁｮｳﾘｮｸﾊﾞ	半張力場	名詞
ﾊﾝﾁｮｳｼﾞｸ	半長軸	名詞
ﾊﾝﾁｭｳｾｲｼ	反中性子	名詞
ﾊﾝﾕﾆﾀﾘｰｴﾝｻﾞﾝｼ	反ユニタリー演算子	名詞
ﾊﾝﾖｳｼ	反陽子	名詞
ﾊﾝｼﾞﾊﾞ	反磁場	名詞
ﾊﾝｼﾞﾊﾞｹｲｽｳ	反磁場係数	名詞
ﾊﾝｼﾞｾｲ	反磁性	名詞
ﾊﾝｼﾞｾｲﾀｲ	反磁性体	名詞
ﾊﾚｰｼｮﾝ	ハレーション	名詞
ﾊﾚﾂ	波列	名詞
ﾊﾘｶﾞﾈｺｳｼ	針金格子	名詞
ﾊﾛｹﾞﾝｶｱﾙｶﾘ	ハロゲン化アルカリ	名詞
ﾊｰﾙｿｸﾄﾞ	ハール測度	名詞
ﾊﾙﾄﾏﾝ	ﾊﾙﾄﾏﾝ	人名
ﾊﾙﾄﾏﾝ	Hartmann	人名
ﾊﾙﾄﾏﾝﾉﾌﾞﾝｻﾝｼｷ	ハルトマンの分散式	名詞
ﾊﾙﾄﾏﾝﾉﾅｶﾞﾚ	ハルトマンの流れ	名詞
ﾊﾙﾄﾏﾝｼﾎﾞﾘ	ハルトマン絞り	名詞
ﾊﾙﾄﾏﾝｽｳ	ハルトマン数	名詞
ﾊｻｲﾊﾝﾉｳ	破砕反応	名詞
ﾊｻｲｾｲｾｲﾌﾞﾂ	破砕生成物	名詞
ﾊｼｺﾞｶﾞﾀｶｲﾛ	はしご型回路	名詞
ﾊｼｺﾞｶﾞﾀﾉﾀﾞｲﾔｸﾞﾗﾑ	はしご型のダイヤグラム	名詞
ﾊｼｺﾞｷﾝｼﾞ	はしご近似	名詞
ﾊｿｸ	波束	名詞
ﾊｿｸﾉｼｭｳｼｭｸ	波束の収縮	名詞
ﾊﾝｻﾝﾃｲﾘ	発散定理	名詞
ﾊｯｼｬﾀｲ	発射体	名詞
ﾊｽｳ	波数	名詞
ﾊｽｳﾍﾞｸﾄﾙ	波数ベクトル	名詞
ﾊｽｳｸｳｶﾝ	波数空間	名詞
ﾊﾁﾄﾞｳｾﾂ	八道説	名詞
ﾊﾁｷｮｸﾓｰﾒﾝﾄ	八極モーメント	名詞
ﾊﾁｷｮｸｼﾓｰﾒﾝﾄ	八極子モーメント	名詞
ﾊﾁｷｮｸﾍﾝｹｲ	八極変形	名詞
ﾊﾁｷｮｸｼﾝﾄﾞｳ	八極振動	名詞
ﾊﾁﾒﾝﾀｲｲﾁ	八面体位置	名詞
ﾊﾁｼﾞｭｳｺｳ	八重項	名詞
ﾊﾁｼﾞｭｳｾﾝ	八重線	名詞
ﾊｰﾄﾘｰﾌｫｯｸｷﾝｼﾞ	ハートリー・フォック近似	名詞
ﾊｰﾄﾘｰﾌｫｯｸﾎﾟﾃﾝｼｬﾙ	ハートリー・フォックポテンシャル	名詞
ﾊｰﾄﾘｰﾌｫｯｸｽﾚｰﾀｰﾎｳ	ハートリー・フォック・スレーター法	名詞
ﾊｰﾄﾘｰｷﾝｼﾞ	ハートリー近似	名詞
ﾊｰﾄﾘｰ	ハートリー	人名
ﾊｰﾄﾘｰ	Hartree	人名
ﾊｯﾃﾝﾎｳﾃｲｼｷ	発展方程式	名詞
ﾊﾂｴﾙｺﾞﾝﾊﾝﾉｳ	発エルゴン反応	名詞
ﾊﾁｮｳﾊﾞﾝ	波長板	名詞
ﾊﾁｮｳﾋｮｳｼﾞｭﾝ	波長標準	名詞
ﾊﾁｮｳｶﾍﾝﾚｰｻﾞｰ	波長可変レーザー	名詞
ﾊﾁｮｳｹｲ	波長計	名詞
ﾊﾁｮｳﾉｼﾝｸｳﾎｾｲ	波長の真空補正	名詞
ﾊﾁｮｳﾃｲｽｳ	波長定数	名詞
ﾊｳﾘﾝｸﾞ	ハウリング	名詞
ﾊｳｽﾄﾞﾙﾌｼﾞｹﾞﾝ	ハウスドルフ次元	名詞
ﾊﾔｲﾋﾞｰﾑﾄﾘﾀﾞｼ	速いビーム取出し	名詞
ﾊﾔｼﾌｪｲｽﾞ	林フェイズ	名詞
ﾊｼﾞｷﾀﾞｼｴﾈﾙｷﾞｰ	はじき出しエネルギー	名詞
ﾊｽﾞﾐｸﾞﾙﾏ	はずみ車	名詞
ﾊｼﾞｮｳﾃﾝｲ	刃状転位	名詞
ﾍｲｴﾝｻﾞﾝｼ	閉演算子	名詞
ﾍｲｶｲﾛ	閉回路	名詞
ﾍｲｶｸ	閉殻	名詞
ﾍｲｶﾝ	閉管	名詞
ﾍｲｶﾂｶｲﾛ	平滑回路	名詞
ﾍｲｶﾂｺｲﾙ	平滑コイル	名詞
ﾍｲｶﾂｺﾝﾃﾞﾝｻｰ	平滑コンデンサー	名詞
ﾍｲｶﾂﾁｮｰｸ	平滑チョーク	名詞
ﾍｲｷﾄﾞｳ	閉軌道	名詞
ﾍｲｷﾄﾞｳﾋｽﾞﾐ	閉軌道ひずみ	名詞
ﾍｲｷﾝﾊﾞｷﾝｼﾞ	平均場近似	名詞
ﾍｲｷﾝﾌﾞﾝｼﾘｮｳ	平均分子量	名詞
ﾍｲｷﾝﾃﾞﾝﾘｮｸ	平均電力	名詞
ﾍｲｷﾝｺﾞｻ	平均誤差	名詞
ﾍｲｷﾝﾋﾃｲ	平均飛程	名詞
ﾍｲｷﾝｶｸｼｶﾝｶｸ	平均核子間隔	名詞
ﾍｲｷﾝｶｿｸﾄﾞ	平均加速度	名詞
ﾍｲｷﾝｺｳｾｲｼﾞ	平均恒星時	名詞
ﾍｲｷﾝｷｮｸｼｮｳｼﾞﾊﾞ	平均極小磁場	名詞
ﾍｲｷﾝﾆｼﾞｮｳﾊﾝｹｲ	平均二乗半径	名詞
ﾍｲｷﾝﾆｼﾞｮｳｻﾁｮｳ	平均二乗鎖長	名詞
ﾍｲｷﾝﾎﾟﾃﾝｼｬﾙ	平均ポテンシャル	名詞
ﾍｲｷﾝﾚﾝｻﾁｮｳ	平均連鎖長	名詞
ﾍｲｷﾝﾘﾂ	平均律	名詞
ﾍｲｷﾝｿｸﾄﾞ	平均速度	名詞
ﾍｲｷﾝｼｮｳﾄﾂｼﾞｶﾝ	平均衝突時間	名詞
ﾍｲｷﾝﾀｲﾖｳﾋﾞ	平均太陽日	名詞
ﾍｲｷﾝﾀｲﾖｳｼﾞ	平均太陽時	名詞
ﾍｲｷﾝｼﾞﾕｳｺｳﾃｲ	平均自由行程	名詞
ﾍｲｷﾝｼﾞﾕｳｼﾞｶﾝ	平均自由時間	名詞
ﾍｲｷﾝｼﾞｭﾐｮｳ	平均寿命	名詞
ﾍｲｺｳﾊﾞﾝﾄﾞ	平行バンド	名詞
ﾍｲｺｳﾊﾞﾝｺﾝﾃﾞﾝｻｰ	平行板コンデンサー	名詞
ﾍｲｺｳﾃﾞﾝｶ	平衡電荷	名詞
ﾍｲｺｳｶﾞﾀｹｰﾌﾞﾙ	平衡型ケーブル	名詞
ﾍｲｺｳﾌﾍｲｺｳﾍﾝｶﾝｷ	平衡不平衡変換器	名詞
ﾍｲｺｳｲﾄﾞｳ	平行移動	名詞
ﾍｲｺｳｶｸｶﾝｷｮﾘ	平衡核間距離	名詞
ﾍｲｺｳｷﾄﾞｳ	平衡軌道	名詞
ﾍｲｺｳﾆｺﾙ	平行ニコル	名詞
ﾍｲｺｳﾆｺﾙﾉｼﾞｮｳﾀｲ	平行ニコルの状態	名詞
ﾍｲｺｳﾁｮｸ	平行力	名詞
ﾍｲｺｳﾃｲｽｳ	平衡定数	名詞
ﾍｲｺｳｼﾞｶﾘﾂ	平行磁化率	名詞
ﾍｲﾒﾝﾀﾞｲﾔｸﾞﾗﾑ	平面ダイヤグラム	名詞
ﾍｲﾒﾝﾄﾞ	平面度	名詞
ﾍｲﾒﾝﾊ	平面波	名詞
ﾍｲﾒﾝﾊｷﾝｼﾞ	平面波近似	名詞
ﾍｲﾒﾝﾍﾝｺｳ	平面偏光	名詞
ﾍｲﾒﾝﾋｽﾞﾐ	平面ひずみ	名詞
ﾍｲﾒﾝﾎﾛｸﾞﾗﾑ	平面ホログラム	名詞
ﾍｲﾒﾝｷｮｳ	平面鏡	名詞
ﾍｲﾒﾝｵｳﾘｮｸ	平面応力	名詞
ﾍｲﾚﾂｷｮｳｼﾝ	並列共振	名詞
ﾍｲﾚﾂｾﾂｿﾞｸ	並列接続	名詞
ﾍｲﾙｰﾌﾟｾｲｷﾞｮ	閉ループ制御	名詞
ﾍｲｼﾝﾌﾍﾝｾｲ	並進不変性	名詞
ﾍｲｼﾝﾀｲｼｮｳ	並進対称	名詞
ﾍｲｼﾝﾁﾂｼﾞｮ	並進秩序	名詞
ﾍｲｼﾝｳﾝﾄﾞｳ	並進運動	名詞
ﾍｲﾀﾝｹｲ	閉端系	名詞
ﾍｷｶｲ	へき開	名詞
ﾍｷｶｲﾒﾝ	へき開面	名詞
ﾍﾝﾋﾞﾌﾞﾝ	偏微分	名詞
ﾍﾝﾋﾞﾌﾞﾝﾎｳﾃｲｼｷ	偏微分方程式	名詞
ﾍﾝﾌﾞﾝｹﾞﾝﾘ	偏分原理	名詞
ﾍﾝﾌﾞﾝﾎｳ	変分法	名詞
ﾍﾝﾌｸｸﾁｮｳｿｳﾁ	変復調装置	名詞
ﾍﾝｲ	偏移	名詞
ﾍﾝｲﾃﾞﾝﾘｭｳ	変位電流	名詞
ﾍﾝｲｴﾝｻﾞﾝｼ	変位演算子	名詞
ﾍﾝｲｶﾞﾀｷｮｳﾕｳﾃﾞﾝﾀｲ	変位型強誘電体	名詞
ﾍﾝｲﾎｳ	偏位法	名詞
ﾍﾝｲｽﾊﾟｲｸ	変位スパイク	名詞
ﾍﾝｶｸ	偏角	名詞
ﾍﾝｶｸｼﾝﾄﾞｳ	変角振動	名詞
ﾍﾝｶﾝｸﾞﾝ	変換群	名詞
ﾍﾝｶﾝﾘﾛﾝ	変換理論	名詞
ﾍﾝｹｲｶｸ	変形核	名詞
ﾍﾝｹｲﾎﾟﾃﾝｼｬﾙ	変形ポテンシャル	名詞
ﾍﾝｹｲﾘｮｳｲｷ	変形領域	名詞
ﾍﾝｹｲｼﾝﾄﾞｳ	変形振動	名詞
ﾍﾝｹｲｿｳｼｮｳ	変形双晶	名詞
ﾍﾝｺｳ	偏光	名詞
ﾍﾝｺｳﾌﾞﾝｶﾂ	偏光分割	名詞
ﾍﾝｺｳﾌﾞﾝｺｳﾎｳ	偏光分光法	名詞
ﾍﾝｺｳﾀﾞｴﾝ	偏光だ円	名詞
ﾍﾝｺｳﾀﾞｴﾝ	偏光楕円	名詞
ﾍﾝｺｳﾃﾞﾝｼﾞｼｬｸ	偏向電磁石	名詞
ﾍﾝｺｳﾄﾞ	偏光度	名詞
ﾍﾝｺｳﾌｨﾙﾀｰ	偏光フィルター	名詞
ﾍﾝｺｳｲﾝｼ	偏光因子	名詞
ﾍﾝｺｳｶｲｾｷﾎｳ	偏光解析法	名詞
ﾍﾝｺｳｶｲｾｷｿｳﾁ	偏光解析装置	名詞
ﾍﾝｺｳｶｸ	偏光角	名詞
ﾍﾝｺｳｶﾝｼｮｳｹｲ	偏光干渉計	名詞
ﾍﾝｺｳｹｲ	偏光計	名詞
ﾍﾝｺｳｹﾝﾋﾞｷｮｳ	偏光顕微鏡	名詞
ﾍﾝｺｳｷ	偏光器	名詞
ﾍﾝｺｳｺｲﾙ	偏向コイル	名詞
ﾍﾝｺｳﾒﾝ	偏光面	名詞
ﾍﾝｺｳﾉｳ	偏光能	名詞
ﾍﾝｺｳﾌﾟﾘｽﾞﾑ	偏光プリズム	名詞
ﾍﾝｺｳﾗﾏﾝｻﾝﾗﾝ	偏光ラマン散乱	名詞
ﾍﾝｺｳｾｲ	変光星	名詞
ﾍﾝｺｳｼ	偏光子	名詞
ﾍﾝｷｮｸ	偏極	名詞
ﾍﾝｷｮｸﾋﾞｰﾑ	偏極ビーム	名詞
ﾍﾝｷｮｸﾃﾞﾝｶ	偏極電荷	名詞
ﾍﾝｷｮｸﾄﾞ	偏極度	名詞
ﾍﾝｷｮｸｹﾞﾝｼｮｳ	偏極減少	名詞
ﾍﾝｷｮｸｹﾞﾝｼｮｳﾄﾞ	偏極減少度	名詞
ﾍﾝｷｮｸﾋｮｳﾃｷ	偏極標的	名詞
ﾍﾝｷｮｸｲｵﾝｹﾞﾝ	偏極イオン源	名詞
ﾍﾝｷｮｸｶｲｾｷ	偏極解析	名詞
ﾍﾝｷｮｸｶｲｾｷﾉｳ	偏極解析能	名詞
ﾍﾝｷｮｸｶｸ	偏極核	名詞
ﾍﾝｷｮｸｺｳｶ	偏極効果	名詞
ﾍﾝｷｮｸﾃﾝｿﾙ	偏極テンソル	名詞
ﾍﾝﾊﾟ	偏波	名詞
ﾍﾝﾊﾟｷ	偏波器	名詞
ﾍﾝﾊﾟﾒﾝ	偏波面	名詞
ﾍﾝﾚｷﾃﾞﾝｼｼﾞｾｲ	遍歴電子磁性	名詞
ﾍﾝﾘｰ	ヘンリー	名詞
ﾍﾝﾘｰ	Henry	人名
ﾍﾝﾘｰﾉﾎｳｿｸ	ヘンリーの法則	名詞
ﾍﾝﾘｰﾉｼｷ	ヘンリーの式	名詞
ﾍﾝﾙﾛﾝﾄﾞﾝｺｳｼｷ	ヘンル・ロンドン公式	名詞
ﾍﾝｻ	偏差	名詞
ﾍﾝｾｷ	偏析	名詞
ﾍﾝｾﾝｺｳ	変旋光	名詞
ﾍﾝｼﾝﾘﾂ	偏心率	名詞
ﾍﾝﾁｮｳﾌﾞﾝｺｳﾎｳ	変調分光法	名詞
ﾍﾝﾁｮｳﾄﾞ	変調度	名詞
ﾍﾝﾁｮｳﾄﾞｰﾌﾟｺｳｿﾞｳ	変調ドープ構造	名詞
ﾍﾝﾁｮｳﾎｳ	変調法	名詞
ﾍﾝﾁｮｳｺｳｿﾞｳ	変調構造	名詞
ﾍﾝﾁｮｳｼｽｳ	変調指数	名詞
ﾍﾘｶﾙﾃﾝｲ	ヘリカル転位	名詞
ﾍﾘｯｸｽｶﾞﾀｶｿｸｷ	ヘリックス型加速器	名詞
ﾍﾘｯｸｽｺｲﾙﾃﾝｲ	ヘリックス-コイル転移	名詞
ﾍﾘｺﾝﾊ	ヘリコン波	名詞
ﾍﾘｵｽﾀｯﾄ	ヘリオスタット	名詞
ﾍﾘｼﾃｨ	ヘリシティ	名詞
ﾍﾘｳﾑｶﾄﾞﾐｳﾑﾚｰｻﾞｰ	ヘリウム-カドミウムレーザー	名詞
ﾍﾘｳﾑﾈｵﾝﾚｰｻﾞｰ	ヘリウム-ネオンレーザー	名詞
ﾍﾙｸﾞﾛｯﾂｶﾝｽｳ	ヘルグロッツ関数	名詞
ﾍﾙﾏﾝﾌｧｲﾝﾏﾝﾉﾃｲﾘ	ヘルマン・ファインマンの定理	名詞
ﾍﾙﾏﾝﾓｰｶﾞﾝﾉｷｺﾞｳ	ヘルマン・モーガンの記号	名詞
ﾍﾙﾑﾎﾙﾂ	ヘルムホルツ	人名
ﾍﾙﾑﾎﾙﾂ	Helmholtz	人名
ﾍﾙﾑﾎﾙﾂﾊ	ヘルムホルツ波	名詞
ﾍﾙﾑﾎﾙﾂﾎｳﾃｲｼｷ	ヘルムホルツ方程式	名詞
ﾍﾙﾑﾎﾙﾂｺｲﾙ	ヘルムホルツコイル	名詞
ﾍﾙﾑﾎﾙﾂｷｮｳﾒｲｷ	ヘルムホルツ共鳴器	名詞
ﾍﾙﾑﾎﾙﾂﾉﾌｱﾝﾃｲｾｲ	ヘルムホルツの不安定性	名詞
ﾍﾙﾑﾎﾙﾂﾉｳｽﾞﾃｲﾘ	ヘルムホルツの渦定理	名詞
ｼﾞﾕｳｴﾈﾙｷﾞｰ	自由エネルギー	名詞
ﾍﾙﾂﾍﾞｸﾄﾙ	ヘルツベクトル	名詞
ﾍﾙﾂﾊ	ヘルツ波	名詞
ﾍﾙﾂｷｮｳｼﾝｷ	ヘルツ共振器	名詞
ﾍﾙﾂﾉｼﾞｯｹﾝ	ヘルツの実験	名詞
ﾍﾙﾂｼｭﾌﾟﾙﾝｸﾞﾗｯｾﾙ	ヘルツシュプルング・ラッセル	人名
ﾍｽﾉﾎｳｿｸ	ヘスの法則	名詞
ﾍﾃﾛﾀﾞｲﾝ	ヘテロダイン	名詞
ﾍﾃﾛﾀﾞｲﾝﾌﾞﾝｺｳ	ヘテロダイン分光	名詞
ﾍﾃﾛｺｳｿﾞｳ	ヘテロ構造	名詞
ﾍﾃﾛｾﾂｺﾞｳ	ヘテロ接合	名詞
ﾊﾞｲﾎﾟｰﾗﾄﾗﾝｼﾞｽﾀｰ	バイポーラトランジスター	名詞
ﾍﾃﾛﾀｸﾁｯｸｺｳﾌﾞﾝｼ	ヘテロタクチック高分子	名詞
ﾋｱｯｼｭｸｾｲﾘｭｳﾀｲ	非圧縮性流体	名詞
ﾋﾊﾞﾅｷﾞｬｯﾌﾟ	火花ギャップ	名詞
ﾋﾊﾞﾅﾎｳﾃﾞﾝ	火花放電	名詞
ﾋﾌﾞﾝｻﾝｾｲ	非分散性	名詞
ﾋﾀﾞﾝﾈﾂｺｳ	非断熱項	名詞
ﾋﾀﾞﾝﾈﾂﾎﾟﾃﾝｼｬﾙ	非断熱ポテンシャル	名詞
ﾋﾀﾞﾝｾｲ	非弾性	名詞
ﾋﾀﾞﾝｾｲﾄﾞ	非弾性度	名詞
ﾋﾀﾞﾝｾｲﾋｶﾘｻﾝﾗﾝ	非弾性光散乱	名詞
ﾋﾀﾞﾝｾｲｼｮｳﾄﾂ	非弾性衝突	名詞
ﾋﾀﾞﾝｾｲｻﾝﾗﾝ	非弾性散乱	名詞
ﾋﾀﾞﾘｴﾝﾍﾝｺｳ	左円偏光	名詞
ﾋﾀﾞﾘﾃﾉﾎｳｿｸ	左手の法則	名詞
ﾋﾃﾞﾝｶ	比電荷	名詞
ﾋﾃﾞﾝｷｶﾝｼﾞｭﾘﾂ	比電気感受率	名詞
ﾋﾃﾞﾝﾘ	比電離	名詞
ﾋﾃﾞﾝﾘﾉｳ	比電離能	名詞
ﾋｹﾞｹｯｼｮｳ	ひげ結晶	名詞
ﾋｸﾞｽｷｺｳ	ヒグス機構	名詞
ﾋﾊｶｲｹﾝｻ	非破壊検査	名詞
ﾋﾍｲｺｳ	非平衡	名詞
ﾋﾍｲｺｳﾈﾂﾘｷｶﾞｸ	非平衡熱力学	名詞
ﾋﾍｲｺｳﾄｳｹｲﾘｷｶﾞｸ	非平衡統計力学	名詞
ﾋﾎｳｼｬﾉｳ	比放射能	名詞
ﾋﾌｸｸﾞﾝ	被覆群	名詞
ﾋﾌｸﾘﾂ	被覆率	名詞
ﾋﾋｮｳﾒﾝｾｷ	比表面積	名詞
ﾋｰﾄﾎﾟﾝﾌﾟ	ヒートポンプ	名詞
ﾋｶｶﾞｸﾘｮｳﾛﾝｾｲ	非化学量論性	名詞
ﾋｶｶﾝｹﾞｰｼﾞﾘﾛﾝ	非可換ゲージ理論	名詞
ﾋｶｶﾝｸﾞﾝ	非可換群	名詞
ﾋｶｸｶｲﾛ	比較回路	名詞
ﾋｶｸｿｸﾃｲ	比較測定	名詞
ﾋｶｸｽﾍﾟｸﾄﾙ	比較スペクトル	名詞
ﾋｶﾆｯｹﾙｶﾞﾀｺｳｿﾞｳ	ヒ化ニッケル型構造	名詞
ﾋｶﾝｼｮｳｾｲ	非干渉性	連体詞
ﾋｶﾘｱｲｿﾚｰﾀｰ	光アイソレーター	名詞
ﾋｶﾘﾋﾞｰﾄ	光ビート	名詞
ﾋｶﾘﾌﾞﾝｶｲ	光分解	名詞
ﾋｶﾘﾌﾞﾝｶｲﾎｳ	光分解法	名詞
ﾋｶﾘﾀﾞﾂﾘ	光脱離	名詞
ﾋｶﾘﾃﾞﾝﾘ	光電離	名詞
ﾋｶﾘﾃﾞﾝｿｳ	光伝送	名詞
ﾋｶﾘﾃﾞﾝﾀﾂｶﾝｽｳ	光伝達関数	名詞
ﾋｶﾘﾃﾞﾝｼﾞｺｳｶ	光電磁効果	名詞
ﾋｶﾘﾄﾞｳﾊﾛ	光導波路	名詞
ﾋｶﾘｴﾚｸﾄﾚｯﾄ	光エレクトレット	名詞
ﾋｶﾘｴﾚｸﾄﾛﾆｸｽ	光エレクトロニクス	名詞
ﾋｶﾘﾌｧｲﾊﾞｰ	光ファイバー	名詞
ﾋｶﾘﾊﾝﾉｳ	光反応	名詞
ﾋｶﾘﾍﾝｺｳ	光偏向	名詞
ﾋｶﾘﾍﾝｺｳｷ	光偏向器	名詞
ﾋｶﾘﾍﾝﾁｮｳ	光変調	名詞
ﾋｶﾘﾍﾝﾁｮｳｷ	光変調器	名詞
ﾋｶﾘﾍﾃﾛﾀﾞｲﾝ	光ヘテロダイン	名詞
ﾋｶﾘﾎﾓﾀﾞｲﾝ	光ホモダイン	名詞
ﾋｶﾘｲｾｲｶ	光異性化	名詞
ﾋｶﾘｶｲﾘ	光解離	名詞
ﾋｶﾘｶｲﾘﾚｰｻﾞｰ	光解離レーザー	名詞
ﾋｶﾘｶｸﾌﾞﾝﾚﾂ	光核分裂	名詞
ﾋｶﾘｶｸﾊﾝﾉｳ	光核反応	名詞
ﾋｶﾘｷｴﾝﾊﾟｷ	光検波器	名詞
ﾋｶﾘｹﾝｼｭﾂｷ	光検出器	名詞
ﾋｶﾘｹﾂｺﾞｳﾄﾗﾝｼﾞｽﾀｰ	光結合トランジスター	名詞
ﾋｶﾘｷﾃﾞﾝｺｳｶ	光起電効果	名詞
ﾋｶﾘｷﾃﾞﾝﾘｮｸ	光起電力	名詞
ﾋｶﾘｷﾃﾞﾝﾘｮｸｺｳｶ	光起電力効果	名詞
ﾋｶﾘｺﾝｺﾞｳ	光混合	名詞
ﾋｶﾘｺｳｵﾝｹｲ	光高温計	名詞
ﾋｶﾘｺｳﾁｮｳﾊﾊｯｾｲ	光高調波発生	名詞
ﾋｶﾘｺｳｿﾞｳﾍﾝｶ	光構造変化	名詞
ﾋｶﾘｷｮｳｼﾝｷ	光共振器	名詞
ﾋｶﾘﾒﾓﾘｰ	光メモリー	名詞
ﾋｶﾘｵﾝｷｮｳﾌﾞﾝｺｳﾎｳ	光音響分光法	名詞
ﾋｶﾘﾊﾟﾗﾒﾄﾘｯｸﾊｯｼﾝ	光パラメトリック発振	名詞
ﾋｶﾘﾊﾟﾗﾒﾄﾘｯｸｻﾝﾗﾝ	光パラメトリック散乱	名詞
ﾋｶﾘﾊﾟﾗﾒﾄﾘｯｸｿﾞｳﾌｸ	光パラメトリック増幅	名詞
ﾋｶﾘﾊﾟﾙｽｱｯｼｭｸ	光パルス圧縮	名詞
ﾋｶﾘﾎﾟﾝﾋﾟﾝｸﾞ	光ポンピング	名詞
ﾋｶﾘﾚｲｷﾚｰｻﾞｰ	光励起レーザー	名詞
ﾋｶﾘｻﾝﾗﾝ	光散乱	名詞
ﾋｶﾘｾｲﾘｭｳ	光整流	名詞
ﾋｶﾘｾｲｾｲ	光生成	名詞
ﾋｶﾘｿｳｱﾝﾃｲｾｲ	光双安定性	名詞
ﾋｶﾘｿﾝｼｮｳ	光損傷	名詞
ﾋｶﾘｽｲｯﾁ	光スイッチ	名詞
ﾋｶﾘｽﾋﾟﾝｾｲﾚﾂ	光スピン整列	名詞
ﾋｶﾘｼｬｯﾀｰ	光シャッター	名詞
ﾋｶﾘｼｮｳｼｬ	光照射	名詞
ﾋｶﾘｼｭｳｾｷｶｲﾛ	光集積回路	名詞
ﾋｶﾘﾃｺ	光てこ	名詞
ﾋｶﾘﾄｳｶｾｲﾃﾞﾝｷｮｸ	光透過性電極	名詞
ﾋｶﾘﾄｼﾞｺﾒ	光閉込め	名詞
ﾋｶﾘﾂｳｼﾝ	光通信	名詞
ﾋｶﾘﾁｬｰﾌﾟ	光チャープ	名詞
ﾋｶﾘﾁｭｳｾｲｼ	光中性子	名詞
ﾋｶﾘｼﾞｾｲ	光磁性	名詞
ﾋｶﾘｿﾞｳﾌｸｷ	光増幅器	名詞
ﾋｶﾘｼﾞｭｳｺﾞｳ	光重合	名詞
ﾋｹﾂｺﾞｳｷﾄﾞｳ	非結合軌道	名詞
ﾋｹﾂｺﾞｳｾｲｷﾄﾞｳ	非結合性軌道	名詞
ﾋｷｺﾐｹﾞﾝｼｮｳ	引込み現象	名詞
ﾋｯｶｷｶﾀｻ	引っかき硬さ	名詞
ﾋｯｸﾏﾝﾎﾟﾝﾌﾟ	ヒックマンポンプ	名詞
ﾋｺｳｶｾｲｻﾞｲﾘｮｳ	非硬化性材料	名詞
ﾋｺｳｻｿｸ	非交差則	名詞
ﾋｺｳｼﾞｶﾝﾎｳ	飛行時間法	名詞
ﾋｷｮｸｼｮﾊﾞ	非局所場	名詞
ﾋｷｮｸｼｮﾎﾟﾃﾝｼｬﾙ	非局所ポテンシャル	名詞
ﾋｷｮｸｻﾞｲｶ	非局在化	名詞
ﾋｷｭｳﾒﾝ	非球面	名詞
ﾋｷｭｳﾒﾝｶｲｾﾂｺｳｼ	非球面回折格子	名詞
ﾋｷｭｳﾒﾝﾚﾝｽﾞ	非球面レンズ	名詞
ﾋﾅﾁｭﾗﾙﾊﾟﾘﾃｨ	非ナチュラルパリティ	名詞
ﾋﾝﾄﾞｲﾝｼ	頻度因子	名詞
ﾋﾈﾝﾄﾞ	比粘度	名詞
ﾋﾈﾝｾｲﾘｭｳﾀｲ	非粘性流体	名詞
ﾋﾈﾂ	比熱	名詞
ﾋﾈﾂﾋ	比熱比	名詞
ﾋﾈﾂﾃｷﾎｳｼｬ	比熱的放射	名詞
ﾋﾉﾀﾏﾓｹｲ	火の玉模型	名詞
ﾋﾝﾖｳﾊﾞｲ	貧溶媒	名詞
ﾋﾆｭｰﾄﾝﾈﾝｾｲ	非ニュートン粘性	名詞
ﾋﾆｭｰﾄﾝﾘｭｳﾄﾞｳ	非ニュートン流動	名詞
ﾋﾆｭｰﾄﾝﾘｭｳﾀｲ	非ニュートン流体	名詞
ﾋｵｰﾐｯｸﾃﾞﾝﾄﾞｳ	非オーミック伝導	名詞
ﾋｵｰﾑﾃｲｺｳ	非オーム抵抗	名詞
ﾋｵｰﾑﾃｷﾃﾞﾝﾄﾞｳ	非オーム的伝導	名詞
ﾋｵﾝｷｮｳｲﾝﾋﾟｰﾀﾞﾝｽ	比音響インピーダンス	名詞
ﾋｯﾊﾟﾘｵｳﾘｮｸ	引張応力	名詞
ﾋｯﾊﾟﾘﾂﾖｻ	引張強さ	名詞
ﾋﾗｲｷ	避雷器	名詞
ﾋﾗｲﾀｹｲ	開いた系	名詞
ﾋﾚｲﾄﾞｳｻ	比例動作	名詞
ﾋﾚｲｹﾞﾝﾄﾞ	比例限度	名詞
ﾋﾚｲｹｲｽｳｶﾝ	比例計数管	名詞
ﾋﾚｲｿﾞｳﾌｸｷ	比例増幅器	名詞
ﾋﾚﾌﾟﾄﾝﾎｳｶｲ	非レプトン崩壊	名詞
ﾋﾘﾂｹｲ	比率計	名詞
ﾋﾘﾂｾｲｷﾞｮ	比率制御	名詞
ﾋﾛｳｹﾞﾝﾄﾞ	疲労限度	名詞
ﾋﾛｳｷｮｳﾄﾞ	疲労強度	名詞
ﾋﾛｳｼｹﾝ	疲労試験	名詞
ﾋﾙﾍﾞﾙﾄﾍﾝｶﾝ	ヒルベルト変換	名詞
ﾋﾙﾍﾞﾙﾄｸｳｶﾝ	ヒルベルト空間	名詞
ﾋﾙﾎｳﾃｲｼｷ	ヒル方程式	名詞
ﾋﾙﾉｳｽﾞ	ヒルの渦	名詞
ﾋｾｲｺﾞｳﾊﾝｼｬ	非整合反射	名詞
ﾋｾｲｺﾞｳｺｳｿﾞｳ	非整合構造	名詞
ﾋｾｲｺﾞｳﾃﾝｲ	非整合転移	名詞
ﾋｾｲｼﾞﾛｰﾚﾝﾂｸﾞﾝ	非斉次ローレンツ群	名詞
ﾋｾｷ	飛跡	名詞
ﾋｾｷｹﾝｼｭﾂｷ	飛跡検出器	名詞
ﾋｾﾝｹｲ	非線形	連体詞
ﾋｾﾝｹｲﾌﾞﾝｺｳｶﾞｸ	非線形分光学	名詞
ﾋｾﾝｹｲﾃﾞﾝﾄﾞｳ	非線形伝導	名詞
ﾋｾﾝｹｲﾊﾄﾞｳ	非線形波動	名詞
ﾋｾﾝｹｲｶﾝｼﾞｭﾘﾂ	非線形感受率	名詞
ﾋｾﾝｹｲﾋｶﾘｶﾝｼﾞｭﾘﾂ	非線形光感受率	名詞
ﾋｾﾝｹｲｺｳｶﾞｸ	非線形光学	名詞
ﾋｾﾝｹｲｶｲﾛ	非線形回路	名詞
ﾋｾﾝｹｲｸｯｾﾂﾘﾂ	非線形屈折率	名詞
ﾋｾﾝｹｲｷｮｳｼﾝ	非線形共振	名詞
ﾋｾﾝｹｲﾈﾝﾀﾞﾝｾｲ	非線形粘弾性	名詞
ﾋｾﾝｹｲｵﾝｷｮｳｶﾞｸ	非線形音響学	名詞
ﾋｾﾝｹｲｼﾝﾄﾞｳ	非線形振動	名詞
ﾋｾﾝｹｲｿｼ	非線形素子	名詞
ﾋｾﾝｺｳﾄﾞ	比旋光度	名詞
ﾋｾｯｻｸｶｺｳ	非切削加工	名詞
ﾋｾﾂﾄﾞｳｻ	非摂動鎖	名詞
ﾋｼｶﾝﾄﾞ	比視感度	名詞
ﾋｼﾂﾘｮｳﾍﾝｻ	比質量偏差	名詞
ﾋｿｳﾃﾞﾝﾘｮｸ	皮相電力	名詞
ﾋｿｶﾞﾀｺｳｿﾞｳ	ヒ素型構造	名詞
ﾋｽｲﾖｳｴｷ	非水溶液	名詞
ﾋｽﾃﾘｼｽ	ヒステリシス	名詞
ﾋｽﾃﾘｼｽｷｮｸｾﾝ	ヒステリシス曲線	名詞
ﾋｽﾃﾘｼｽｿﾝ	ヒステリシス損	名詞
ﾋｽﾃﾘｼｽｿﾝｼﾂ	ヒステリシス損失	名詞
ﾋｽﾄｸﾞﾗﾑ	ヒストグラム	名詞
ﾋｼｮｸﾎｳ	比色法	名詞
ﾋｼｮｸｹｲ	比色計	名詞
ﾋｼｮｸｾﾝﾘｮｳｹｲ	比色線量計	名詞
ﾋｼｮｳｼﾂ	非晶質	連体詞
ﾋｼｮｳｼﾂﾊﾝﾄﾞｳﾀｲ	非晶質半導体	名詞
ﾋｼｮｳｼﾂｷﾝｿﾞｸ	非晶質金属	名詞
ﾋｼｭｳｷｹｲ	非周期系	名詞
ﾋﾀｲｾｷ	比体積	名詞
ﾋﾀｲｼｮｳｶｲﾃﾝｼﾓｹｲ	非対称回転子模型	名詞
ﾋﾀｲｼｮｳｺﾏ	非対称こま	名詞
ﾋﾀｲｼｮｳｺﾏﾌﾞﾝｼ	非対称こま分子	名詞
ﾋﾀｲｼｮｳｺﾏｶﾞﾀﾌﾞﾝｼ	非対称こま型分子	名詞
ﾋﾀｲｼｮｳｾｲﾊﾟﾗﾒｰﾀｰ	非対称性パラメーター	名詞
ﾋﾃｲ	飛程	名詞
ﾋﾃｲﾉﾕﾗｷﾞ	飛程のゆらぎ	名詞
ﾋﾃｲﾖｳﾄﾞｳ	飛程揺動	名詞
ﾋﾃﾝｼｭｳｻ	非点収差	名詞
ﾋﾄｳｼﾞﾘﾂ	比透磁率	名詞
ﾋｯﾁｺｯｸﾍﾞｱｽﾄｳﾎｳ	ヒッチコック・ベアストウ法	名詞
ﾋﾁｮｸｾﾝﾃｲｺｳ	非直線抵抗	名詞
ﾋﾁｮｳﾜｺｳ	非調和項	名詞
ﾋﾁｮｳﾜｾｲ	非調和性	名詞
ﾋﾁｮｳﾜｼﾝﾄﾞｳ	非調和振動	名詞
ﾋﾁｮｳﾜｼﾝﾄﾞｳｼ	非調和振動子	名詞
ﾋﾁｭｳｼﾝﾘｮｸ	非中心力	名詞
ﾋﾕｳﾃﾞﾝﾘﾂ	比誘電率	名詞
ﾋﾕｳｶｲｴﾝｻﾞﾝｼ	非有界演算子	名詞
ﾋﾕｳﾘﾀﾝｲｹｲ	非有理単位系	名詞
ﾋｼﾞｶﾘﾂ	比磁化率	名詞
ﾋｼﾞｿﾞｸﾎｳﾃﾞﾝ	非自続放電	名詞
ﾋｽﾞﾐﾀﾞｴﾝﾀｲ	ひずみだ円体	名詞
ﾋｽﾞﾐﾀﾞｴﾝﾀｲ	ひずみ楕円体	名詞
ﾋｽﾞﾐｴﾈﾙｷﾞｰ	ひずみエネルギー	名詞
ﾋｽﾞﾐｹﾞｰｼﾞ	ひずみゲージ	名詞
ﾋｽﾞﾐﾊ	ひずみ波	名詞
ﾋｽﾞﾐﾊﾎﾞﾙﾝｷﾝｼﾞ	ひずみ波ボルン近似	名詞
ﾋｽﾞﾐﾊｷﾝｼﾞ	ひずみ波近似	名詞
ﾋｽﾞﾐｺｳｶ	ひずみ硬化	名詞
ﾋｽﾞﾐﾉﾀﾞｴﾝﾀｲ	ひずみのだ円体	名詞
ﾋｽﾞﾐﾉﾀﾞｴﾝﾀｲ	ひずみの楕円体	名詞
ﾋｽﾞﾐﾉﾆｼﾞｷｮｸﾒﾝ	ひずみの二次曲面	名詞
ﾋｽﾞﾐﾘﾂ	ひずみ率	名詞
ﾋｽﾞﾐｿｸﾄﾞ	ひずみ速度	名詞
ﾋｽﾞﾐｿｸﾄﾞﾃﾝｿﾙ	ひずみ速度テンソル	名詞
ﾋｽﾞﾐｼｮｳﾄﾞﾝﾎｳ	ひずみ焼鈍法	名詞
ﾋｽﾞﾐﾃﾝｿﾙ	ひずみテンソル	名詞
ﾋｼﾞｭｳﾋﾞﾝ	比重瓶	名詞
ﾋｼﾞｭｳｹｲ	比重計	名詞
ﾎｱﾝｻﾝﾗﾝ	ホアン散乱	名詞
ﾎｳﾌﾞﾂﾒﾝｷｮｳ	放物面鏡	名詞
ﾎｳﾌﾞﾂｳﾝﾄﾞｳ	放物運動	名詞
ﾎｳﾃﾞﾝﾊﾞｺ	放電箱	名詞
ﾎｳﾃﾞﾝｲｼﾞﾃﾞﾝｱﾂ	放電維持電圧	名詞
ﾎｳﾃﾞﾝｶｲｼﾃﾞﾝｱﾂ	放電開始電圧	名詞
ﾎｳﾃﾞﾝｶｺｳ	放電加工	名詞
ﾎｳﾃﾞﾝｶﾝ	放電管	名詞
ﾎｳﾃﾞﾝｷﾛｸ	放電記録	名詞
ﾎｳﾃﾞﾝﾚｲｷﾚｰｻﾞｰ	放電励起レーザー	名詞
ﾎｳﾃﾞﾝｾﾝｼﾞｮｳﾎｳ	放電洗浄法	名詞
ﾎｳﾃﾞﾝﾄｳ	放電灯	名詞
ﾎﾄﾞｸﾞﾗﾌ	ホドグラフ	名詞
ﾎｶﾞｲ	補外	名詞
ﾎｺﾞｶﾝ	保護環	名詞
ﾎﾌｸﾘｭｳ	ほふく流	名詞
ﾎｲﾍﾝｽﾌﾚﾈﾙﾉｹﾞﾝﾘ	ホイヘンス・フレネルの原理	名詞
ﾎｲﾍﾝｽﾉｹﾞﾝﾘ	ホイヘンスの原理	名詞
ﾎｲｰﾄｽﾄﾝﾌﾞﾘｯｼﾞ	ホイートストンブリッジ	名詞
ﾎｳｲﾘｮｳｼｽｳ	方位量子数	名詞
ﾎｳｶｲｹｲﾚﾂ	崩壊系列	名詞
ﾎｳｶｲｷｮｸｾﾝ	崩壊曲線	名詞
ﾎｳｶｲﾘﾂ	崩壊率	名詞
ﾎｳｶｲｾｷｶﾞﾀｺｳｿﾞｳ	方解石型構造	名詞
ﾎｳｶｲﾃｲｽｳ	崩壊定数	名詞
ﾎｶｸﾀﾞﾝﾒﾝｾｷ	捕獲断面積	名詞
ﾎｶｸﾊﾝﾉｳ	捕獲反応	名詞
ﾎｶｸﾀｲｶｸﾌﾞﾝﾚﾂﾋ	捕獲対核分裂比	名詞
ﾎｳｹｲﾊ	方形波	名詞
ﾎｰｹｲｽｳ	ホー係数	名詞
ﾎｹﾝﾌﾞﾂﾘｶﾞｸ	保健物理学	名詞
ﾎｳｺｳﾘｮｳｼｶ	方向量子化	名詞
ﾎｳｺｳｾｲｹﾂｺﾞｳ	方向性結合	名詞
ﾎｳｺｳｾｲｺｳｶ	方向性効果	名詞
ﾎｺｳｿ	補酵素	名詞
ﾎﾓﾀﾞｲﾝ	ホモダイン	名詞
ﾎﾓﾒﾄﾘｯｸｺｳｿﾞｳ	ホモメトリック構造	名詞
ﾎﾓﾄﾋﾟｰ	ホモトピー	名詞
ﾎｰﾆﾝｸﾞ	ホーニング	名詞
ﾎｯﾋﾟﾝｸﾞﾃﾞﾝﾄﾞｳ	ホッピング伝導	名詞
ﾎｯﾋﾟﾝｸﾞｾｷﾌﾞﾝ	ホッピング積分	名詞
ﾎﾌﾟｷﾝｿﾝｺｳｶ	ホプキンソン効果	名詞
ﾎﾛｸﾞﾗﾌｨｰｶﾝｼｮｳﾎｳ	ホログラフィー干渉法	名詞
ﾎﾛｸﾞﾗﾌｨｯｸｶｲｾﾂｺｳｼ	ホログラフィック回折格子	名詞
ﾎﾛﾉｰﾙｹｲ	ホロノール系	名詞
ﾎｰﾙﾊﾞｰﾆﾝｸﾞ	ホールバーニング	名詞
ﾎｰﾙﾃﾞｨﾝｸﾞﾎﾟﾝﾌﾟ	ホールディングポンプ	名詞
ﾎｰﾙｲﾄﾞｳﾄﾞ	ホール移動度	名詞
ﾎｰﾙｶｸ	ホール角	名詞
ﾎｰﾙｹｲｽｳ	ホール係数	名詞
ﾎｰﾙｺｳｶ	ホール効果	名詞
ﾎﾙﾏﾝﾄ	ホルマント	名詞
ﾎｰﾙｿｼ	ホール素子	名詞
ﾎｰﾙﾜｲﾄﾏﾝﾉﾃｲﾘ	ホール・ワイトマンの定理	名詞
ﾎｾｲﾚﾝｽﾞ	補正レンズ	名詞
ﾎｳｾﾝﾀﾞｴﾝﾀｲ	法線楕円体	名詞
ﾎｳｾﾝﾀﾞｴﾝﾀｲ	法線だ円体	名詞
ﾎｳｾﾝ	法線	名詞
ﾎｳｾﾝｶｿｸﾄﾞ	法線加速度	名詞
ﾎｳｾﾝｵｳﾘｮｸ	法線応力	名詞
ﾎｳｾﾝﾘｮｸ	法線力	名詞
ﾎｳｾﾝｿｸﾄﾞ	法線速度	名詞
ﾎｳｾﾝｿｸﾄﾞﾒﾝ	法線速度面	名詞
ﾎｳｼｬｾｲｺｳｶﾌﾞﾂ	放射性降下物	名詞
ﾎｼｶﾞﾀｹｯｾﾝ	星形結線	名詞
ﾎｼｶﾞﾀｾﾂｿﾞｸ	星形接続	名詞
ﾎｼﾉｼｭｿﾞｸ	星の種族	名詞
ﾎｿｸﾘｭｳｼ	捕捉粒子	名詞
ﾎｳｼｬｱﾂ	放射圧	名詞
ﾎｳｼｬｴﾈﾙｷﾞｰ	放射エネルギー	名詞
ﾎｳｼｬｹﾞﾝｽｲ	放射減衰	名詞
ﾎｳｼｬﾍｲｺｳ	放射平衡	名詞
ﾎｳｼｬﾎｳｶｲ	放射崩壊	名詞
ﾎｳｼｬﾎｶｸ	放射捕獲	名詞
ﾎｳｼｬﾎｾｲ	放射補正	名詞
ﾎｳｼｬﾎｳｿｸ	放射法則	名詞
ﾎｳｼｬｲﾝﾋﾟｰﾀﾞﾝｽ	放射インピーダンス	名詞
ﾎｳｼｬｶ	放射化	名詞
ﾎｳｼｬｶﾌﾞﾝｾｷ	放射化分析	名詞
ﾎｳｼｬｶﾀﾞﾝﾒﾝｾｷ	放射化断面積	名詞
ﾎｳｼｬｶｹﾝｼｭﾂｷ	放射化検出器	名詞
ﾎｳｼｬｹｲ	放射計	名詞
ﾎｳｼｬﾉｳﾍｲｺｳ	放射能平衡	名詞
ﾎｳｼｬﾉｳﾉｳﾄﾞ	放射能濃度	名詞
ﾎｳｼｬﾉｳｵｾﾝ	放射能汚染	名詞
ﾎｳｼｬﾉｳｼﾞｮｾﾝ	放射能除染	名詞
ﾎｳｼｬｵﾝﾄﾞｹｲ	放射温度計	名詞
ﾎｳｼｬﾘﾂ	放射率	名詞
ﾎｳｼｬｻｲｹﾂｺﾞｳ	放射再結合	名詞
ﾎｳｼｬｾｲﾌﾞｯｼﾂ	放射性物質	名詞
ﾎｳｼｬｾｲﾄﾞｳｲｹﾞﾝｿ	放射性同位元素	名詞
ﾎｳｼｬｾｲﾄﾞｳｲｶｸ	放射性同位核	名詞
ﾎｳｼｬｾｲﾄﾞｳｲﾀｲ	放射性同位体	名詞
ｽｷｬﾆﾝｸﾞ	スキャニング	名詞
ﾎｳｼｬｾｲﾄﾞｸｾｲ	放射性毒性	名詞
ﾎｳｼｬｾｲｹﾞﾝｿ	放射性元素	名詞
ﾎｳｼｬｾｲﾊｲｷﾌﾞﾂ	放射性廃棄物	名詞
ﾎｳｼｬｾｲﾎｳｶｲ	放射性崩壊	名詞
ﾎｳｼｬｾｲﾎｶｸ	放射性捕獲	名詞
ﾎｳｼｬｾｲﾌﾁｬｸ	放射性付着	名詞
ﾎｳｼｬｾｲｶｸｼｭ	放射性核種	名詞
ﾍﾝｲﾎｳｿｸ	変位法則	名詞
ﾎｳｼｬｾｲｼｼﾞﾔｸ	放射性指示薬	名詞
ﾎｳｼｬｾﾝｱﾂﾐｹｲ	放射線厚み計	名詞
ﾎｳｼｬｾﾝﾎﾞｳｺﾞ	放射線防護	名詞
ﾎｳｼｬｾﾝﾎﾞｳｺﾞｻﾞｲ	放射線防護剤	名詞
ﾎｳｼｬｾﾝﾌﾞﾝｶｲ	放射線分解	名詞
ﾎｳｼｬｾﾝﾌﾞﾂﾘｶﾞｸ	放射線物理学	名詞
ﾎｳｼｬｾﾝﾃﾞﾝﾁ	放射線電池	名詞
ﾎｳｼｬｾﾝｹﾞﾝ	放射線源	名詞
ﾎｳｼｬｾﾝﾊｯｾｲｿｳﾁ	放射線発生装置	名詞
ﾎｳｼｬｾﾝﾌｶ	放射線負荷	名詞
ﾎｳｼｬｾﾝｶﾝｼﾞｭｾｲ	放射性感受性	名詞
ﾎｳｼｬｾﾝｹﾝｼｭﾂｷ	放射線検出器	名詞
ﾎｳｼｬｾﾝｺｳｶ	放射線効果	名詞
ﾎｳｼｬｾﾝﾓﾆﾀｰ	放射線モニター	名詞
ﾎｳｼｬｾﾝﾙﾐﾈｾﾝｽ	放射線ルミネセンス	名詞
ﾎｳｼｬｾﾝﾘｮｳ	放射線量	名詞
ｾｲﾀｲｶﾞｸﾃｷﾉｳｼｭｸ	生態学的濃縮	名詞
ﾎｳｼｬｾﾝｼﾝｸｳｹｲ	放射線真空計	名詞
ﾎｳｼｬｾﾝｿﾝｼｮｳ	放射線損傷	名詞
ﾎｳｼｬｾﾝｽﾄﾘｰﾐﾝｸﾞ	放射線ストリーミング	名詞
ﾎｳｼｬｾﾝｼｬﾍｲ	放射線遮蔽	名詞
ﾎｳｼｬｾﾝﾀｲ	放射線帯	名詞
ﾎｳｼｬｾﾝﾃｲｺｳｾｲ	放射線抵抗性	名詞
ﾎｳｼｬｾﾝﾁﾘｮｳ	放射線治療	名詞
ﾎｳｼｬｾﾝｿﾞｳｶﾝ	放射線増感	名詞
ﾎｳｼｬｾﾝｼﾞｭｳｺﾞｳ	放射線重合	名詞
ﾎｳｼｬｿｸ	放射束	名詞
ﾎｳｼｬｿﾝ	放射損	名詞
ﾎｳｼｬｿﾝｼﾂ	放射損失	名詞
ﾎｳｼｬﾃｲｺｳ	放射抵抗	名詞
ﾎｳｼｬﾄｳｷｭｳ	放射等級	名詞
ﾎｳｼｬﾁｮｳ	放射長	名詞
ﾎｳｼｮｳ	包晶	名詞
ﾎｼｮｳﾄﾞｳｾﾝ	補償導線	名詞
ﾎｼｮｳｷ	補償器	名詞
ﾎｼｮｳﾉﾃｲﾘ	補償の定理	名詞
ﾎｼｮｳｵﾝﾄﾞ	補償温度	名詞
ﾎｳｼｭﾂﾘﾂ	放出率	名詞
ﾎｳｼｭﾂｽﾍﾟｸﾄﾙ	放出スペクトル	名詞
ﾎﾀﾙｲｼｶﾞﾀｺｳｿﾞｳ	蛍石型構造	名詞
ﾎｳﾃﾌﾞﾅﾝﾉﾃｲﾘ	鳳・テブナンの定理	名詞
ﾎﾄﾀﾞｲｵｰﾄﾞ	ホトダイオード	名詞
ﾎﾄﾝﾄﾞｼﾞﾕｳﾅﾃﾞﾝｼ	ほとんど自由な電子	名詞
ﾎﾄﾝｴｺｰ	ホトンエコー	名詞
ﾎﾄﾚｼﾞｽﾄ	ホトレジスト	名詞
ﾎﾄﾙﾐﾈｾﾝｽ	ホトルミネセンス	名詞
ﾎﾄﾄﾗﾝｼﾞｽﾀｰ	ホトトランジスター	名詞
ﾎｯﾄｱﾄﾑ	ホットアトム	名詞
ﾎｯﾄﾊﾞﾝﾄﾞ	ホットバンド	名詞
ﾎｯﾄﾃﾞﾝｼ	ホット電子	名詞
ﾎｯﾄｴﾚｸﾄﾛﾝ	ホットエレクトロン	名詞
ﾎｯﾄｹｰﾌﾞ	ホットケーブ	名詞
ﾎｯﾄﾗﾎﾞ	ホットラボ	名詞
ﾎｯﾄｾﾙ	ホットセル	名詞
ﾎｳﾜｱﾂﾘｮｸ	飽和圧力	名詞
ﾎｳﾜﾌﾞﾝｺｳﾎｳ	飽和分光法	名詞
ﾎｳﾜﾌﾞﾝｷｮｸ	飽和分極	名詞
ﾎｳﾜﾃﾞﾝﾘｭｳ	飽和電流	名詞
ﾎｳﾜﾄﾞ	飽和度	名詞
ﾎｳﾜｴｷｾﾝ	飽和液線	名詞
ﾎｳﾜｷｮｸｾﾝ	飽和曲線	名詞
ﾎｳﾜｹﾞﾝｶｲｷｮｸｾﾝ	飽和限界曲線	名詞
ﾎｳﾜﾊﾊﾞ	飽和幅	名詞
ﾎｳﾜｷｭｳｼｭｳ	飽和吸収	名詞
ﾎｳﾜｵﾝﾄﾞ	飽和温度	名詞
ﾎｳﾜｾｲ	飽和性	名詞
ﾎｳﾜｾｲｷｭｳｼｭｳﾀｲ	飽和性吸収体	名詞
ﾎｳﾜｾｲﾘｱｸﾄﾙ	飽和性リアクトル	名詞
ﾎｳﾜｼﾞｶ	飽和磁化	名詞
ﾎｳﾜｼﾞｮｳｷ	飽和蒸気	名詞
ﾎｳﾜｼﾞｮｳｷｱﾂ	飽和蒸気圧	名詞
ﾎｳﾜｼﾞｮｳｷｱﾂｷｮｸｾﾝ	飽和蒸気圧曲線	名詞
ﾎｳﾜｼﾞｮｳｷｾﾝ	飽和蒸気線	名詞
ﾎｼﾞﾘｮｸ	保磁力	名詞
ﾎｿﾞﾝﾎｳｿｸ	保存法則	名詞
ﾎｿﾞﾝｶﾚﾝﾄ	保存カレント	名詞
ﾎｿﾞﾝｹｲ	保存系	名詞
ﾎｿﾞﾝﾘｮｸ	保存力	名詞
ﾎｿﾞﾝｿｸ	保存則	名詞
ﾎｼﾞｮﾎﾟﾝﾌﾟ	補助ポンプ	名詞
ﾎｼﾞｮﾀﾝｲ	補助単位	名詞
ﾌｱﾝﾃｲﾍｲｺｳ	不安定平衡	名詞
ﾏﾙﾁﾊﾞｲﾌﾞﾚｰﾀｰ	マルチバイブレーター	名詞
ﾌｱﾝﾃｲﾂﾘｱｲ	不安定釣合い	名詞
ﾌｱﾝﾃｲｼﾞｮｳﾀｲ	不安定状態	名詞
ﾌﾄﾞｳｼｮｳｽｳﾃﾝﾋｮｳｼﾞ	浮動小数点表示	名詞
ﾌﾄﾞｳﾃﾝ	不動点	名詞
ﾌﾄﾞｳｼﾞｭｳﾃﾞﾝ	浮動充電	名詞
ﾌｴﾈﾙｷﾞｰﾊ	負エネルギー波	名詞
ﾌｴﾈﾙｷﾞｰｼﾞｮｳﾀｲ	負エネルギー状態	名詞
ﾌｶﾞｼﾃｨ	フガシティ	名詞
ﾌｸﾞﾛｰ	負グロー	名詞
ﾌﾍﾝﾌﾞﾌﾞﾝｸﾞﾝ	不変部分群	名詞
ﾌﾍﾝﾌﾞﾌﾞﾝｸｳｶﾝ	不変部分空間	名詞
ﾌﾍﾝﾃﾞﾙﾀｶﾝｽｳ	不変Δ関数	名詞
ﾌﾍﾝﾃﾞﾙﾀｶﾝｽｳ	不変${\mit\Delta}$関数	名詞
ﾌﾍﾝﾃﾞﾙﾀｶﾝｽｳ	不変{\mit\Delta}関数	名詞
ﾌﾍﾝﾌｪﾙﾐｿｳｺﾞｻﾖｳ	普遍フェルミ相互作用	名詞
ﾌﾍﾝｾｲ	不変性	名詞
ﾌﾍﾝｼﾂﾘｮｳ	不変質量	名詞
ﾌﾍﾝﾃｲｽｳ	普遍定数	名詞
ﾌｲｵﾝ	負イオン	名詞
ﾌｲｵﾝｹﾞﾝ	負イオン源	名詞
ﾌｲｵﾝﾆｭｳｼｬ	負イオン入射	名詞
ﾌｶｷﾞｬｸｹﾞﾝｼｮｳ	不可逆現象	名詞
ﾌｶｷﾞｬｸｶﾃｲ	不可逆過程	名詞
ﾌｶｷﾞｬｸｷｶﾝ	不可逆機関	名詞
ﾌｶｷﾞｬｸｻｲｸﾙ	不可逆サイクル	名詞
ﾌｶｷﾞｬｸｿｼ	不可逆素子	名詞
ﾌｶｲﾝﾋﾟｰﾀﾞﾝｽ	負荷インピーダンス	名詞
ﾌｶｲｼﾞｭﾝｲ	深い準位	名詞
ﾌｶｸﾃｲｾｲｶﾝｹｲ	不確定性関係	名詞
ﾌｶｸﾃｲﾄｸｲﾃﾝ	不確定特異点	名詞
ﾌｶﾝｾﾞﾝｹｯｼｮｳ	不完全結晶	名詞
ﾌｶﾝｾﾞﾝｷﾀｲ	不完全気体	名詞
ﾌｶﾝｼﾞｶﾝ	不感時間	名詞
ﾌｶｼﾞｭｳｺﾞｳ	付加重合	名詞
ﾌｹｯｼｮｳ	負結晶	名詞
ﾌｷｶﾝ	負帰還	名詞
ﾌｷﾝｲﾂﾅﾋﾛｶﾞﾘ	不均一な広がり	名詞
ﾌｷﾝｼﾂﾌﾟﾗｽﾞﾏ	不均質プラズマ	名詞
ﾌｷﾝｼﾂﾁｮｳﾃﾞﾝﾄﾞｳﾀｲ	不均質超伝導体	名詞
ﾌｷｿｸｷﾞﾝｶﾞ	不規則銀河	名詞
ﾌｷｿｸｶﾃｲ	不規則過程	名詞
ﾌｷｿｸｼﾝﾄﾞｳ	不規則振動	名詞
ﾌｷﾄﾘｼｹﾝ	ふき取り試験	名詞
ﾌｯｸﾀﾞﾝｾｲ	フック弾性	名詞
ﾌｯｸﾉﾎｳｿｸ	フックの法則	名詞
ﾌｰｺｰﾃﾞﾝﾘｭｳ	フーコー電流	名詞
ﾌｰｺｰﾌﾘｺ	フーコー振り子	名詞
ﾌｺﾛﾅ	負コロナ	名詞
ﾌｰｺｰﾃｽﾄ	フーコーテスト	名詞
ﾌｸﾌﾞﾝｻﾝ	副分散	名詞
ﾌｸｺﾞｳｶﾞﾀｱﾜﾊﾞｺ	複合型泡箱	名詞
ﾌｸｺﾞｳｲｵﾝ	複合イオン	名詞
ﾌｸｺﾞｳｶｸ	複合核	名詞
ﾌｸｺﾞｳｶｸﾀﾞﾝｾｲｻﾝﾗﾝ	複合核弾性散乱	名詞
ﾌｸｺﾞｳｹｰﾌﾞﾙ	複合ケーブル	名詞
ﾌｸｺﾞｳｺｳｼ	複合格子	名詞
ﾌｸｺﾞｳｵﾝ	複合音	名詞
ﾌｸｺﾞｳﾘｭｳｼ	複合粒子	名詞
ﾌｸｺﾞｳﾀｼﾝｾﾝ	複合多心線	名詞
ﾌｯｸｺﾞｳﾁｭｳｼﾝ	複合中心	名詞
ﾌｸｺﾞｳﾕﾃﾞﾝﾀｲ	複合誘電体	名詞
ﾌｸｺﾞｳｻﾞｲﾘｮｳ	複合材料	名詞
ﾌｸﾌﾘｺ	複振り子	名詞
ﾌｸｹｯｼｮｳ	複結晶	名詞
ﾌｸｺｳｶﾞｸｼﾞｸ	副光学軸	名詞
ﾌｸｸｯｾﾂ	複屈折	名詞
ﾌｸﾌﾟﾘｽﾞﾑ	複プリズム	名詞
ﾌｸｼﾝﾌﾟﾛｰﾌﾞ	複針プローブ	名詞
ﾌｸｿｳ	ふくそう	名詞
ﾌｸｿｱﾄﾞﾐﾀﾝｽ	複素アドミタンス	名詞
ﾌｸｿ	複素	名詞
ﾌｸｿﾀﾞﾝｾｲﾘﾂ	複素弾性率	名詞
ﾌｸｿﾃﾞﾝｱﾂ	複素電圧	名詞
ﾌｸｿﾃﾞﾝﾘｭｳ	複素電流	名詞
ﾌｸｿﾃﾞﾝﾘｮｸ	複素電力	名詞
ﾌｸｿﾊｽｳ	複素波数	名詞
ﾌｸｿﾍｲﾒﾝ	複素平面	名詞
ﾌｸｿｲﾝﾋﾟｰﾀﾞﾝｽ	複素インピーダンス	名詞
ﾌｸｿｶﾝｽｳ	複素関数	名詞
ﾌｸｿｺﾋｰﾚﾝｽﾄﾞ	複素コヒーレンス度	名詞
ﾌｸｿｸｯｾﾂﾘﾂ	複素屈折率	名詞
ﾌｸｿﾅｲﾌﾞﾎﾟﾃﾝｼｬﾙ	複素内部ポテンシャル	名詞
ﾌｸｿﾈﾝｾｲﾘﾂ	複素粘性率	名詞
ﾌｸｿｵﾝｿｸﾄﾞ	複素音速度	名詞
ﾌｸｿﾎﾟﾃﾝｼｬﾙ	複素ポテンシャル	名詞
ﾌｸｿｼﾝﾌﾟｸ	複素振幅	名詞
ﾌｸｿｿｸﾄﾞ	複素速度	名詞
ﾌｸｿｿｸﾄﾞﾎﾟﾃﾝｼｬﾙ	複素速度ポテンシャル	名詞
ﾌｸｿｽｳﾋｮｳｼﾞ	複素数表示	名詞
ﾌｸｿﾕｳﾃﾞﾝﾘﾂ	複素誘電率	名詞
ﾌｸｿｼﾞｶﾘﾂ	複素磁化率	名詞
ﾌｸｿﾞｳｿｼ	複像素子	名詞
ﾌﾝﾍﾞﾂｼｮｳｼｭﾂ	分別晶出	名詞
ﾌﾝﾏﾂｶｲｾﾂ	粉末回折	名詞
ﾌﾝｻﾝ	噴散	名詞
ﾌﾝｽｲｺｳｶ	噴水効果	名詞
ﾌﾝﾄﾉｹﾂｺﾞｳｹｲｼｷ	フントの結合形式	名詞
ﾌﾝﾄﾉｷｿｸ	フントの規則	名詞
ﾌｳﾆｭｳｶﾞﾀXｾﾝｶﾝ	封入型X線管	名詞
ﾌｵﾝﾄﾞ	負温度	名詞
ﾌｵﾝﾄﾞﾌﾞﾝﾌﾟ	負温度分布	名詞
ﾌﾗｯｸｽﾌﾞﾝﾌﾟ	フラックス分布	名詞
ﾌﾗｯｸｽﾎｳ	フラックス法	名詞
ﾌﾗｯｸｽﾋﾟｰｷﾝｸﾞ	フラックスピーキング	名詞
ﾌﾗｯｸｽﾎﾟﾝﾌﾟ	フラックスポンプ	名詞
ﾌﾗｸｿｲﾄﾞ	フラクソイド	名詞
ﾌﾗｸﾀﾙ	フラクタル	名詞
ﾌﾗﾝｸﾍﾙﾂﾉｼﾞｯｹﾝ	フランク・ヘルツの実験	名詞
ﾌﾗﾝｸｺﾝﾄﾞﾝｲﾝｼ	フランク・コンドン因子	名詞
ﾌﾗﾝｸｺﾝﾄﾞﾝﾉｹﾞﾝﾘ	フランク・コンドンの原理	名詞
ﾌﾗﾝｸ	フランク	人名
ﾌﾗﾝｸ	Frank	人名
ﾌﾗﾝｸﾉﾌﾞﾌﾞﾝﾃﾝｲ	フランクの部分転位	名詞
ﾌﾗﾝｸﾘｰﾄﾞｹﾞﾝ	フランク・リード源	名詞
ﾌﾗﾝｸﾙｰﾌﾟ	フランクループ	名詞
ﾌﾗﾝﾂｹﾙﾃﾞｨｯｼｭｺｳｶ	フランツ・ケルディッシュ効果	名詞
ﾌﾗｯｼｭｵｰﾊﾞｰ	フラッシュオーバー	名詞
ﾌﾗｯｼｭﾌｨﾗﾒﾝﾄﾎｳ	フラッシュフィラメント法	名詞
ﾌﾗｽﾄﾚｰｼｮﾝ	フラストレーション	名詞
ﾌﾗｳﾝﾎｰﾌｧｰｶｲｾﾂ	フラウンホーファー回折	名詞
ﾌﾗｳﾝﾎｰﾌｧｰｵﾝﾊﾞ	フラウンホーファー音場	名詞
ﾌﾗｳﾝﾎｰﾌｧｰｾﾝ	フラウンホーファー線	名詞
ﾌﾚﾐﾝｸﾞﾉﾎｳｿｸ	フレミングの法則	名詞
ﾌﾚｰﾑﾌﾞﾝｺｳﾌﾞﾝｾｷ	フレーム分光分析	名詞
ﾌﾚｰﾑｽﾍﾟｸﾄﾙ	フレームスペクトル	名詞
ﾌﾚﾈﾙ	フレネル	人名
ﾌﾚﾈﾙ	Fresnel	人名
ﾌﾚﾈﾙﾉｶｲｾﾂ	フレネルの回折	名詞
ﾌﾚﾈﾙﾉﾊﾝﾊﾁｮｳﾀｲ	フレネルの半波長帯	名詞
ﾌﾚﾈﾙﾉﾌｸﾌﾟﾘｽﾞﾑ	フレネルの複プリズム	名詞
ﾌﾚﾈﾙﾉｶｶﾞﾐ	フレネルの鏡	名詞
ﾌﾚﾈﾙﾉｼｷ	フレネルの式	名詞
ﾌﾚﾈﾙﾉｼｬﾎｳﾀｲ	フレネルの斜方体	名詞
ﾌﾚﾈﾙﾉﾀｲﾊﾞﾝ	フレネルの帯板	名詞
ﾌﾚﾈﾙﾉｽﾞｲﾊﾝｹｲｽｳ	フレネルの随伴係数	名詞
ﾌﾚﾈﾙｵﾝﾊﾞ	フレネル音場	名詞
ﾌﾚﾈﾙﾚﾝｽﾞ	フレネルレンズ	名詞
ﾌﾚﾈﾙﾀｲ	フレネル帯	名詞
ﾌﾚﾝｹﾙｹｯｶﾝ	フレンケル欠陥	名詞
ﾌﾚﾝｹﾙﾚｲｷｼ	フレンケル励起子	名詞
ﾌﾚﾝｿﾞｸｸﾞﾝ	不連続群	名詞
ﾌﾚﾝｿﾞｸﾒﾝ	不連続面	名詞
ﾌﾚﾝｿﾞｸﾘｭｳ	不連続流	名詞
ﾌﾚﾝｿｸｾﾝ	不連続線	名詞
ﾌﾚｰﾘｯﾋﾓｹｲ	フレーリッヒ模型	名詞
ﾌｰﾘｴ	フーリエ	人名
ﾌｰﾘｴ	Fourier	人名
ﾌｰﾘｴﾌﾞﾝｺｳﾎｳ	フーリエ分光法	名詞
ﾌｰﾘｴﾌﾞﾝｺｳｷ	フーリエ分光器	名詞
ﾌｰﾘｴｺﾞｳｾｲﾎｳ	フーリエ合成法	名詞
ﾌｰﾘｴﾍﾝｶﾝ	フーリエ変換	名詞
ﾌｰﾘｴﾍﾝｶﾝﾌﾞﾝｺｳﾎｳ	フーリエ変換分光法	名詞
ﾌｰﾘｴﾍﾝｶﾝﾌﾞﾝｺｳｷ	フーリエ変換分光器	名詞
ﾌｰﾘｴｶｲｾｷ	フーリエ解析	名詞
ﾌｰﾘｴｺｳｶﾞｸ	フーリエ光学	名詞
ﾌｰﾘｴｷｭｳｽｳ	フーリエ級数	名詞
ﾌｰﾘｴｾｷﾌﾞﾝ	フーリエ積分	名詞
ﾌｰﾘｴﾃﾝｶｲ	フーリエ展開	名詞
ﾌﾘｰﾃﾞﾙ	フリーデル	人名
ﾌﾘｰﾃﾞﾙ	Friedel	人名
ﾌﾘｰﾃﾞﾙﾉｿｳﾜｿｸ	フリーデルの総和則	名詞
ﾌﾘｰﾃﾞﾙｼﾝﾄﾞｳ	フリーデル振動	名詞
ﾌﾘｰﾃﾞﾙｿｸ	フリーデル則	名詞
ﾌﾘｰﾃﾞﾙｿｸﾊｲﾊﾝ	フリーデル則背反	名詞
ﾌﾘｰﾄﾞﾏﾝﾎｳﾃｲｼｷ	フリードマン方程式	名詞
ﾌﾘｰﾄﾞﾘｯｸｽ	フリードリックス	人名
ﾌﾘｯｶｰｻﾞﾂｵﾝ	フリッカー雑音	名詞
ﾌﾘｯｹｾﾝﾘｮｳｹｲ	フリッケ線量計	名詞
ﾌﾘｯﾌﾟﾌﾛｯﾌﾟ	フリップフロップ	名詞
ﾌﾛｱｯｻｰﾙﾉｼﾞｮｳｹﾞﾝ	フロアッサールの上限	名詞
ﾌﾛｲﾝﾄﾘｯﾋﾉｼｷ	フロイントリッヒの式	名詞
ﾌﾛｰｶｳﾝﾀｰ	フローカウンター	名詞
ﾌﾛﾝﾃｨｱｷﾄﾞｳ	フロンティア軌道	名詞
ﾌﾛｰﾘｰ	フローリー	人名
ﾌﾛｰﾘｰ	Flory	人名
ﾌﾛｰﾘｰﾊｷﾞﾝｽﾘﾛﾝ	フローリー・ハギンス理論	名詞
ﾌﾛｰﾘｰﾉｼｷ	フローリーの式	名詞
ﾌﾛｰﾘｰｵﾝﾄﾞ	フローリー温度	名詞
ﾌﾙｰﾄﾞｽｳ	フルード数	名詞
ﾌﾙｰﾄﾌｱﾝﾃｲｾｲ	フルート不安定性	名詞
ﾌﾘｮｸﾉﾁｭｳｼﾝ	浮力の中心	名詞
ﾌﾘｮｸｼﾝﾄﾞｳｽｳ	浮力振動数	名詞
ﾌﾘｮｸﾁｭｳｼﾝ	浮力中心	名詞
ﾌｻｼﾞｮｳﾐｾﾙｺｳｿﾞｳ	房状ミセル構造	名詞
ﾌｾｲｺﾞｳｺｳｿﾞｳ	不整合構造	名詞
ﾌｾｲｺﾞｳﾃﾝｲ	不整合転位	名詞
ﾌｾｲﾃｲ	不静定	連体詞
ﾌｼﾝ	浮心	名詞
ﾌｼﾉﾃﾝ	節の点	名詞
ﾌｼﾂﾘｮｳﾌｱﾝﾃｲｾｲ	負質量不安定性	名詞
ﾌｿｸｹﾞﾝｽｲ	不足減衰	名詞
ﾌｿｸｾｲﾄﾞｳ	不足制動	名詞
ﾌｼｮｸﾋﾛｳ	腐食疲労	名詞
ﾌﾃｲｹｲﾘｮｳ	不定計量	名詞
ﾌﾃｲｺｳ	負抵抗	名詞
ﾌﾁﾝｼ	浮沈子	名詞
ﾌﾄｳﾒｲﾄﾞ	不透明度	名詞
ﾌﾄｳｼｷﾎｳ	不等式法	名詞
ﾌｯﾃﾝｼﾞｮｳｼｮｳ	沸点上昇	名詞
ﾌｯﾄｳｽｲｶﾞﾀｹﾞﾝｼﾛ	沸騰水型原子炉	名詞
ﾌﾂｲﾃﾞﾝｼ	不対電子	名詞
ﾌﾁｬｸｶｸﾘﾂ	付着確率	名詞
ﾌﾁｬｸｹｲｽｳ	付着係数	名詞
ﾌﾕｳﾃﾞﾝｲ	浮遊電位	名詞
ﾌﾕｳﾀｲﾖｳﾕｳﾎｳ	浮遊帯溶融法	名詞
ﾌｼﾞｭﾝﾌﾞﾂﾃﾞﾝﾄﾞｳ	不純物伝導	名詞
ﾌｼﾞｭﾝﾌﾞﾂﾊﾝﾄﾞｳﾀｲ	不純物半導体	名詞
ﾌｼﾞｭﾝﾌﾞﾂﾎｼｮｳ	不純物補償	名詞
ﾌｼﾞｭﾝﾌﾞﾂｶｸｻﾝ	不純物拡散	名詞
ﾌｼﾞｭﾝﾌﾞﾂｻﾝﾗﾝ	不純物散乱	名詞
ﾌｼﾞｭﾝﾌﾞﾂﾀｲ	不純物帯	名詞
ﾌｼﾞｭﾝﾌﾞﾂﾁｭｳｼﾝ	不純物中心	名詞
ﾌｼﾞｭﾝﾌﾞﾂｼﾞｭﾝｲ	不純物準位	名詞
ﾋｮｳﾄﾞｳ	ひょう動	名詞
ﾋｮｳﾋｺｳｶ	表皮効果	名詞
ﾋｮｳﾎﾝｶﾃｲﾘ	標本化定理	名詞
ﾋｮｳﾒﾝｱﾗｻ	表面あらさ	名詞
ﾋｮｳﾒﾝｱﾂ	表面圧	名詞
ﾋｮｳﾒﾝﾌﾞﾝｾｷﾎｳ	表面分析法	名詞
ﾋｮｳﾒﾝﾀﾞﾝｾｲﾊ	表面弾性波	名詞
ﾋｮｳﾒﾝﾃﾞﾝﾄﾞｳﾘﾂ	表面伝導率	名詞
ﾋｮｳﾒﾝﾃﾞﾝｶ	表面電荷	名詞
ﾋｮｳﾒﾝﾃﾞﾝﾘ	表面電離	名詞
ﾋｮｳﾒﾝﾃﾞﾝﾘｭｳ	表面電流	名詞
ﾋｮｳﾒﾝｴﾈﾙｷﾞｰ	表面エネルギー	名詞
ﾋｮｳﾒﾝﾌｫﾉﾝ	表面フォノン	名詞
ﾋｮｳﾒﾝﾊ	表面波	名詞
ﾋｮｳﾒﾝﾊﾝﾉｳ	表面反応	名詞
ﾋｮｳﾒﾝﾍﾝｾｷ	表面偏析	名詞
ﾋｮｳﾒﾝﾋﾌｸﾘﾂ	表面被覆率	名詞
ﾋｮｳﾒﾝｶｶﾞｸﾙﾐﾈｾﾝｽ	表面化学ルミネセンス	名詞
ﾋｮｳﾒﾝｶｸｻﾝ	表面拡散	名詞
ﾋｮｳﾒﾝｶﾝﾜ	表面緩和	名詞
ﾋｮｳﾒﾝｶｯｾｲｻﾞｲ	表面活性剤	名詞
ﾋｮｳﾒﾝｺｳｶ	表面硬化	名詞
ﾋｮｳﾒﾝﾏｻﾂ	表面摩擦	名詞
ﾋｮｳﾒﾝﾏｻﾂﾃｲｺｳ	表面摩擦抵抗	名詞
ﾋｮｳﾒﾝﾐﾂﾄﾞ	表面密度	名詞
ﾋｮｳﾒﾝﾎﾟﾃﾝｼｬﾙ	表面ポテンシャル	名詞
ﾋｮｳﾒﾝﾌﾟﾗｽﾞﾏ	表面プラズマ	名詞
ﾋｮｳﾒﾝﾌﾟﾗｽﾞﾓﾝ	表面プラズモン	名詞
ﾋｮｳﾒﾝﾗﾏﾝｻﾝﾗﾝ	表面ラマン散乱	名詞
ﾋｮｳﾒﾝｻｲｹﾂｺﾞｳ	表面再結合	名詞
ﾋｮｳﾒﾝｼｱｹﾞ	表面仕上げ	名詞
ﾋｮｳﾒﾝｼﾝﾄﾞｳ	表面振動	名詞
ﾋｮｳﾒﾝｿﾚｲｷ	表面素励起	名詞
ｼｮｳﾍｷｶﾞﾀｹﾝｼｭﾂｷ	障壁型検出器	名詞
ﾋｮｳﾒﾝｼｭｳﾘｮｳ	表面収量	名詞
ﾋｮｳﾒﾝﾃｲｺｳ	表面抵抗	名詞
ﾋｮｳﾒﾝﾁｬﾈﾘﾝｸﾞ	表面チャネリング	名詞
ﾋｮｳﾒﾝﾁｮｳﾘｮｸ	表面張力	名詞
ﾋｮｳﾒﾝﾁｮｳﾘｮｸﾊ	表面張力波	名詞
ﾋｮｳﾒﾝｼﾞｾｲ	表面磁性	名詞
ﾋｮｳﾒﾝｼﾞｮｳﾀｲ	表面状態	名詞
ﾋｮｳﾒﾝｼﾞｭﾝｲ	表面準位	名詞
ﾋｮｳｾﾝ	標線	名詞
ﾋｮｳﾃｷｶｸ	標的核	名詞
ﾋｮｳﾃﾝｺｳｶ	氷点降下	名詞
ﾋｮｳｼﾞﾎｳﾃﾞﾝｶﾝ	表示放電管	名詞
ﾋｮｳｼﾞｿｳﾁ	表示装置	名詞
ﾋｮｳｼﾞｭﾝｱﾂﾘｮｸ	標準圧力	名詞
ﾋｮｳｼﾞｭﾝﾃﾞﾝﾊﾟ	標準電波	名詞
ﾋｮｳｼﾞｭﾝﾃﾞﾝﾁ	標準電池	名詞
ﾋｮｳｼﾞｭﾝﾄﾞｹｲ	標準時計	名詞
ﾋｮｳｼﾞｭﾝﾊﾁｮｳ	標準波長	名詞
ﾋｮｳｼﾞｭﾝﾍﾝｻ	標準偏差	名詞
ﾋｮｳｼﾞｭﾝｲﾝﾀﾞｸﾀｰ	標準インダクター	名詞
ﾋｮｳｼﾞｭﾝｶﾝｿｸｼｬ	標準観測者	名詞
ﾋｮｳｼﾞｭﾝｷ	標準器	名詞
ﾋｮｳｼﾞｭﾝｺｳｹﾞﾝ	標準光源	名詞
ﾋｮｳｼﾞｭﾝｺﾝﾃﾞﾝｻｰ	標準コンデンサー	名詞
ﾋｮｳｼﾞｭﾝｵﾝﾄﾞ	標準温度	名詞
ﾋｮｳｼﾞｭﾝｵﾝﾄﾞｹｲ	標準温度計	名詞
ﾋｮｳｼﾞｭﾝﾘｰｸ	標準リーク	名詞
ﾋｮｳｼﾞｭﾝｾﾝｹﾞﾝ	標準線源	名詞
ｼﾝｺﾞｳﾊｯｾｲｷ	信号発生器	名詞
ﾋｮｳｼﾞｭﾝｽｲｿﾃﾞﾝｷｮｸ	標準水素電極	名詞
ﾋｮｳｼﾞｭﾝﾀｲｷｱﾂ	標準大気圧	名詞
ﾋｮｳｼﾞｭﾝﾃｲｺｳｷ	標準抵抗器	名詞
ﾋｮｳｼﾞｭﾝｼﾞｮｳﾀｲ	標準状態	名詞
ﾋｮｳｼﾞｭﾝｼﾞｭｳﾘｮｸ	標準重力	名詞
ﾋｭｯｹﾙﾌﾞﾝｼｷﾄﾞｳﾎｳ	ヒュッケル分子軌道法	名詞
ﾋｭｰﾑﾛｻﾞﾘｰﾉﾎｳｿｸ	ヒューム・ロザリーの法則	名詞
ｲC	IC	名詞
ｲCﾈﾂﾃﾞﾝﾂｲ	IC熱電対	名詞
ｲCRFｶﾈﾂ	ICRF加熱	名詞
ｲMﾊﾟC	IMPAC	名詞
ｲﾝﾄﾞﾎｳ	INDO法	名詞
ｲﾝﾄﾞR	INDOR	名詞
ｲｵZｷｿｸ	IOZ規則	名詞
ｲﾃﾞﾝﾃｷﾎｳｼｬｾﾝｺｳｶ	遺伝的放射線効果	名詞
ｲﾄﾞｳﾄﾞ	易動度	名詞
ｲﾄﾞｳﾄﾞ	移動度	名詞
ｲﾄﾞｳﾄﾞﾀﾝ	移動度端	名詞
ｲﾄﾞｳｴﾈﾙｷﾞｰ	移動エネルギー	名詞
ｲﾄﾞｶﾞﾀﾎﾟﾃﾝｼｬﾙ	井戸型ポテンシャル	名詞
ｲﾄﾞｳｲﾝｼ	移動因子	名詞
ｲﾄﾞｳｶﾝ	移動管	名詞
ｲﾄﾞｳｶﾝﾎｳ	移動管法	名詞
ｲﾄﾞｳｼﾞﾏ	移動じま	名詞
ｲﾎｳｾｲ	異方性	名詞
ｲﾎｳｾｲﾄﾞｳﾀｲ	異方性導体	名詞
ｲﾎｳｾｲｴﾈﾙｷﾞｰ	異方性エネルギー	名詞
ｲﾎｳｾｲﾊﾐﾙﾄﾆｱﾝ	異方性ハミルトニアン	名詞
ｲﾎｳｾｲｺｳｶﾝｿｳｺﾞｻﾖｳ	異方性交換相互作用	名詞
ｲﾎｳｾｲﾘｭｳﾀｲ	異方性流体	名詞
ｲﾎｳｾｲﾃｲｽｳ	異方性定数	名詞
ｲﾎｳｾｲﾁｮｳﾘｭｳﾀｲ	異方性超流体	名詞
ｲﾎｳｾｲｼﾞﾊﾞ	異方性磁場	名詞
ｲｰｸﾞﾙﾏｳﾝﾃｨﾝｸﾞ	イーグルマウンティング	名詞
ｲｶｸﾌﾞﾝｼ	異核分子	名詞
ｲｺﾐ	鋳込	名詞
ｲｺｳｳﾝﾄﾞｳﾘｮｳ	移行運動量	名詞
ｲｷｮｸｹﾂｺﾞｳ	異極結合	名詞
ｲﾒｰｼﾞﾎﾛｸﾞﾗﾑ	イメージホログラム	名詞
ｲﾝﾊﾞｰ	インバー	名詞
ｲﾝﾋﾞﾎﾞ	インビボ	名詞
ｲﾝﾋﾞｰﾑｶﾞﾝﾏｾﾝｺｳｶ	インビームγ線効果	名詞
ｲﾝﾋﾞｰﾑｶﾞﾝﾏｾﾝｺｳｶ	インビーム$\gamma$線効果	名詞
ｲﾝﾋﾞｰﾑｶﾞﾝﾏｾﾝｺｳｶ	インビーム\gamma線効果	名詞
ｲﾝﾋﾞﾄﾛ	インビトロ	名詞
ｲﾝﾎﾞﾘｭｰﾄ	インボリュート	名詞
ｲﾝﾀﾞｸﾀﾝｽ	インダクタンス	名詞
ｲﾝﾀﾞｸﾀﾝｽｹｲ	インダクタンス計	名詞
ｲﾝﾃﾞﾝｶ	陰電荷	名詞
ｲﾝﾃﾞﾝｼ	陰電子	名詞
ｲﾝﾃﾞｨｼｬﾙｵｳﾄｳ	インディシャル応答	名詞
ｲﾝﾄﾞｰﾙ	インドール	名詞
ｲﾝｶﾞｸﾞﾘｰﾝｶﾝｽｳ	因果グリーン関数	名詞
ｲﾝﾌﾚｸﾀｰ	インフレクター	名詞
ｲﾝｶﾃﾝ	引火点	名詞
ｲﾝｺﾋｰﾚﾝﾄｺｳ	インコヒーレント光	名詞
ｲﾝｸﾙｰｼﾌﾞﾊﾝﾉｳ	インクルーシブ反応	名詞
ｲﾝｷｮｸｱﾝﾌﾞ	陰極暗部	名詞
ｲﾝｷｮｸｸﾞﾛｰ	陰極グロー	名詞
ｲﾝｷｮｸｷﾃﾝ	陰極輝点	名詞
ｲﾝｷｮｸｺｳｶ	陰極降下	名詞
ｲﾝｷｮｸｾﾝ	陰極線	名詞
ｲﾝｷｮｸｾﾝｶｲｾﾂ	陰極線回折	名詞
ｲﾝｷｮｸｾﾝｶﾝ	陰極線管	名詞
ｲﾝｷｮｸｾﾝﾙﾐﾈｾﾝｽ	陰極線ルミネセンス	名詞
ｲﾝｷｮｸﾃﾝ	陰極点	名詞
ｲﾝﾊﾟﾙｽｷﾝｼﾞ	インパルス近似	名詞
ｲﾝﾊﾟﾙｽｵｳﾄｳ	インパルス応答	名詞
ｲﾝﾋﾟｰﾀﾞﾝｽ	インピーダンス	名詞
ｲﾝﾋﾟｰﾀﾞﾝｽｷﾞｮｳﾚﾂ	インピーダンス行列	名詞
ｲﾝﾋﾟｰﾀﾞﾝｽｶﾝｽｳ	インピーダンス関数	名詞
ｲﾝﾋﾟｰﾀﾞﾝｽｾｲｺﾞｳ	インピーダンス整合	名詞
ｲﾝｾｲｹﾞﾝｿ	陰性元素	名詞
ｲﾝｼｸﾞﾝ	因子群時	名詞
ｲﾝｼｸﾞﾝﾌﾞﾝﾚﾂ	因子群分裂	名詞
ｲﾝｽﾀﾝﾄﾝ	インスタントン	名詞
ｲﾝｽﾃｰﾄ	インステート	名詞
ｲﾝﾀｰﾌｪﾛｸﾞﾗﾑ	インターフェログラム	名詞
ｲﾝﾀｰｶﾚｰｼｮﾝ	インターカレーション	名詞
ｲﾝﾄﾘﾝｼｯｸｾｷｿｳｹｯｶﾝ	イントリンシック積層欠陥	名詞
ｲﾝﾖｳｺｲﾙ	陰陽コイル	名詞
ｲﾝｼﾞｹｰﾀｰｾﾝｽﾞ	インジケーター線図	名詞
ｲｵﾝﾋﾞｰﾑ	イオンビーム	名詞
ｲｵﾝﾌﾞﾝｷｮｸ	イオン分極	名詞
ｲｵﾝﾌﾞﾝｼﾊﾝﾉｳ	イオン-分子反応	名詞
ｲｵﾝﾃﾞﾝﾄﾞｳ	イオン伝導	名詞
ｲｵﾝﾃﾞﾝﾄﾞｳﾘﾂ	イオン伝導率	名詞
ｲｵﾝﾃﾞﾝﾘｭｳ	イオン電流	名詞
ｲｵﾝﾄﾞｳﾃﾞﾝﾀｲ	イオン導電体	名詞
ｲｵﾝｹﾞﾝ	イオン源	名詞
ｲｵﾝﾊﾝｹｲ	イオン半径	名詞
ｲｵﾝﾎｳﾜﾃﾞﾝﾘｭｳ	イオン飽和電流	名詞
ｲｵﾝｲﾄﾞｳﾄﾞ	イオン移動度	名詞
ｲｵﾝｶ	イオン化	名詞
ｲｵﾝｶﾃﾞﾝｲ	イオン化電位	名詞
ｲｵﾝｶｹﾞﾝｶｲ	イオン化限界	名詞
ｲｵﾝｶｹｲｺｳ	イオン化傾向	名詞
ｲｵﾝｶｸｻﾝ	イオン拡散	名詞
ｲｵﾝｶﾚﾝｿﾞｸｽﾍﾟｸﾄﾙ	イオン化連続スペクトル	名詞
ｲｵﾝｹｯｼｮｳ	イオン結晶	名詞
ｲｵﾝｹﾂｺﾞｳ	イオン結合	名詞
ｲｵﾝｺｳｶﾞｸ	イオン光学	名詞
ｲｵﾝｺｳｿﾞｳ	イオン構造	名詞
ｲｵﾝｷｮｳﾄﾞ	イオン強度	名詞
ｲｵﾝﾏｲｸﾛｱﾅﾗｲｻﾞｰ	イオンマイクロアナライザー	名詞
ｲｵﾝﾏｲｸﾛﾌﾟﾛｰﾌﾞ	イオンマイクロプローブ	名詞
ﾌﾞﾝｾｷｿｳﾁ	分析装置	名詞
ｲｵﾝﾐﾘﾝｸﾞ	イオンミリング	名詞
ｲｵﾝﾐﾂﾄﾞ	イオン密度	名詞
ｲｵﾝｵﾝﾄﾞ	イオン温度	名詞
ｲｵﾝｵﾝﾊﾟ	イオン音波	名詞
ｲｵﾝｵﾝﾊﾟﾌｱﾝﾃｲｾｲ	イオン音波不安定性	名詞
ｲｵﾝﾎﾟﾝﾌﾟ	イオンポンプ	名詞
ｲｵﾝﾌﾟﾗｽﾞﾏｼﾝﾄﾞｳｽｳ	イオンプラズマ振動数	名詞
ｲｵﾝﾗｰﾓｱﾊﾝｹｲ	イオンラーモア半径	名詞
ｲｵﾝﾚｲｷXｾﾝﾌﾞﾝｾｷ	イオン励起X線分析	名詞
ｲｵﾝﾚｰｻﾞｰ	イオンレーザー	名詞
ｲｵﾝｻｲｹﾂｺﾞｳ	イオン再結合	名詞
ｲｵﾝｻｲｸﾛﾄﾛﾝｷｮｳﾒｲ	イオンサイクロトロン共鳴	名詞
ｲｵﾝｻｲｸﾛﾄﾛﾝ	イオンサイクロトロン	名詞
ｲｵﾝｻﾝﾗﾝ	イオン散乱	名詞
ｲｵﾝｾｲｺｳｿﾞｳ	イオン性構造	名詞
ｲｵﾝｾﾝﾀｸｾｲﾃﾞﾝｷｮｸ	イオン選択性電極	名詞
ｲｵﾝｼｰｽ	イオンシース	名詞
ｲｵﾝｼｮｳｹﾞｷ	イオン衝撃K	名詞
ｲｵﾝｼｮｳｹﾞｷﾀﾞﾂﾘ	イオン衝撃脱離	名詞
ｲｵﾝﾄﾗｯﾌﾟﾎｳ	イオントラップ法	名詞
ｲｵﾝﾂｲ	イオン対	名詞
ｲｵﾝﾂｲｾｲｾｲ	イオン対生成	名詞
ｲｵﾝﾁｬﾈﾘﾝｸﾞ	イオンチャネリング	名詞
ｲｵﾝﾁｭｳﾆｭｳ	イオン注入	名詞
ｲｵﾝﾁｭｳｾｲｶ	イオン中性化	名詞
ｲｯﾊﾟﾝｶｲ	一般解	名詞
ｲｯﾊﾟﾝｶｳﾝﾄﾞｳﾘｮｳ	一般化運動量	名詞
ｲｯﾊﾟﾝｶｻﾞﾋｮｳ	一般化座標	名詞
ｲｯﾊﾟﾝｾﾝｹｲｸﾞﾝ	一般線形群	名詞
ｲｯﾊﾟﾝｿｳﾀｲﾛﾝ	一般相対論	名詞
ｲｯﾊﾟﾝｿｳﾀｲｾｲ	一般相対性	名詞
ｲｯﾊﾟﾝｿｳﾀｲｾｲｹﾞﾝﾘ	一般相対性原理	名詞
ｲｯﾊﾟﾝｿｳﾀｲｾｲﾘﾛﾝ	一般相対性理論	名詞
ｲｯﾊﾟﾝｳﾝﾄﾞｳﾘｮｳ	一般運動量	名詞
ｲｯﾊﾟﾝｻﾞﾋｮｳ	一般座標	名詞
ｲｯﾊﾟﾝｻﾞﾋｮｳﾍﾝｶﾝ	一般座標変換	名詞
ｲﾗﾃﾞｨｴｰｼｮﾝ	イラディエーション	名詞
ｲﾗｽﾄｼﾞｭﾝｲ	イラスト準位	名詞
ｲﾛﾍﾝｺｳ	色偏光	名詞
ｲﾛｶﾝﾄﾞ	色感度	名詞
ｲﾛｹｼﾚﾝｽﾞ	色消しレンズ	名詞
ｲﾛﾉｼﾞﾕｳﾄﾞ	色の自由度	名詞
ｲﾛｵﾝﾄﾞ	色温度	名詞
ｲﾛｵﾝﾄﾞﾍﾝｶﾝﾌｨﾙﾀｰ	色温度変換フィルター	名詞
ｲﾛｼｹﾞｷ	色刺激	名詞
ｲﾛｼｭｳｻ	色収差	名詞
ｲﾛﾂｷｸｳｶﾝｸﾞﾝ	色つき空間群	名詞
ｲﾛﾁｭｳｼﾝ	色中心	名詞
ｲﾛﾁｭｳｼﾝﾚｰｻﾞｰ	色中心レーザー	名詞
ｲｾｲｶｴﾈﾙｷﾞｰ	異性化エネルギー	名詞
ｲｾｲｶｸ	異性核	名詞
ｲｾｲｶｸｼﾌﾄ	異性核シフト	名詞
ｲｾｲﾀｲｼﾌﾄ	異性体シフト	名詞
ｲｿｳｱﾝﾃｲｾｲ	位相安定性	名詞
ｲｿｳﾊﾞﾝ	位相板	名詞
ｲｿｳﾍﾞﾝﾍﾞﾂｷ	位相弁別器	名詞
ｲｿｳﾋﾞﾝｶﾝｹﾝﾊﾟ	位相敏感検波	名詞
ｲｿｳｸﾞﾝ	位相群	名詞
ｲｿｳﾍｲｷﾝ	位相平均	名詞
ｲｿｳﾍﾝﾁｮｳ	位相変調	名詞
ｲｿｳﾋｽﾞﾐ	位相ひずみ	名詞
ｲｿｳﾎﾛｸﾞﾗﾑ	位相ホログラム	名詞
ｲｿｳｶｸ	位相角	名詞
ｲｿｳｹﾝﾊﾟ	位相検波	名詞
ｲｿｳｷ	移相器	名詞
ｲｿｳｷﾄﾞｳ	位相軌道	名詞
ｲｿｳｺﾋｰﾚﾝﾄｼﾞｮｳﾀｲ	位相コヒーレント状態	名詞
ｲｿｳｺｳｼ	位相格子	名詞
ｲｿｳｸｳｶﾝ	位相空間	名詞
ｲｿｸﾛﾅｽｻｲｸﾛﾄﾛﾝ	イソクロナスサイクロトロン	名詞
ｲｿｳｷｮｳﾔｸ	位相共役	名詞
ｲｿｳｷｮｳﾔｸﾊ	位相共役波	名詞
ｲｿｳﾓｰﾄﾞ	位相モード	名詞
ｲｿｳﾓﾝﾀﾞｲ	位相問題	名詞
ｲｿｳﾉｽﾞﾚ	位相のずれ	名詞
ｲｿｳﾉｽﾞﾚﾉｶｲｾｷ	位相のずれの解析	名詞
ｲｿｳﾉﾛｯｸﾙｰﾌﾟ	位相のロックループ	名詞
ｲｿｳｻ	位相差	名詞
ｲｿｳｻﾎｳ	位相差法	名詞
ｲｿｳｻｹﾝﾋﾞｷｮｳ	位相差顕微鏡	名詞
ｲｿｳｾｲｺﾞｳ	位相整合	名詞
ｲｿｳｾｷﾌﾞﾝ	位相積分	名詞
ｲｿｳｼ	移相子	名詞
ｲｿｳｼﾝﾄﾞｳ	位相振動	名詞
ｲｿｳｿｸﾄﾞ	位相速度	名詞
ｲｿｳﾀｲｾｷ	位相体積	名詞
ｲｿｳﾃｲｽｳ	位相定数	名詞
ｲｿｳﾖﾕｳ	位相余裕	名詞
ｲｼｭｹﾞﾝｼ	異種原子	名詞
ｲｼｭｾﾂﾄﾞｳ	異種摂動	名詞
ｲﾁﾍﾞｸﾄﾙ	位置ベクトル	名詞
1ﾎﾞｿﾝｺｳｶﾝﾘｮｸ	1ボソン交換力	名詞
ｲﾁﾎﾞｿﾝｺｳｶﾝﾘｮｸ	1ボソン交換力	名詞
ｲﾁﾌﾞﾝｶｲﾉｳ	位置分解能	名詞
ｲﾁﾃﾞﾝｼｷﾝｼﾞ	一電子近似	名詞
ｲﾁｴﾈﾙｷﾞｰ	位置エネルギー	名詞
ｲﾁﾊﾁｮｳﾊﾞﾝ	一波長板	名詞
ｲﾁﾘｭｳｼｴﾈﾙｷﾞｰ	一粒子エネルギー	名詞
ｲﾁﾘｭｳｼｴﾝｻﾞﾝｼ	一粒子演算子	名詞
ｲﾁﾘｭｳｼｲｺｳﾊﾝﾉｳ	一粒子移行反応	名詞
ｲﾁﾘｭｳｼﾓｹｲ	一粒子模型	名詞
ｲﾁﾘｭｳｼﾎﾟﾃﾝｼｬﾙ	一粒子ポテンシャル	名詞
ｲﾁﾘｭｳｼｾﾝｲ	一粒子遷移	名詞
ｲﾁﾘｭｳｼｼﾞｮｳﾀｲ	一粒子状態	名詞
ｲﾁﾘｭｳｼｼﾞｭﾝｲ	一粒子準位	名詞
ｲﾁﾖｳﾘｭｳ	一様流	名詞
ｲﾁﾕｳｶﾝｹﾝｼｭﾂｷ	位置有感検出器	名詞
ｲﾁｼﾞﾋﾞｰﾑ	一次ビーム	名詞
ｲﾁｼﾞﾃﾞﾝﾘｭｳ	一次電流	名詞
ｲﾁｼﾞｹﾞﾝｹｲ	一次元系	名詞
ｲﾁｼﾞﾋｮｳﾃｷ	一次標的	名詞
ｲﾁｼﾞｶｲﾛ	一次回路	名詞
ｲﾁｼﾞｺｲﾙ	一次コイル	名詞
ｲﾁｼﾞｸｹｯｼｮｳ	一軸結晶	名詞
ｲﾁｼﾞｷｮｳﾒｲ	一次共鳴	名詞
ｲﾁｼﾞｵﾝﾄﾞｹｲ	一次温度計	名詞
ｲﾁｼﾞﾘｭｼﾋﾞｰﾑ	一次粒子ビーム	名詞
ｲﾁｼﾞｻｲｹｯｼｮｳ	一次再結晶	名詞
ｲﾁｼﾞｿｳﾃﾝｲ	一次相転移	名詞
ｲﾁｼﾞｼｮｳｽｲ	一次消衰	名詞
ｲﾁｼﾞﾃｲﾃﾝ	一次定点	名詞
ｲﾁｼﾞｳﾁｭｳｾﾝ	一次宇宙線	名詞
ｲﾁｼﾞｼﾞｭｳｿﾞｸ	一次従属	名詞
ｲﾁｼﾞｭｳﾍｲｶｸｶｸ	一重閉殻核	名詞
ｲﾁｼﾞｭｳｹﾂｺﾞｳ	一重結合	名詞
ｲﾁｼﾞｭｳｺｳ	一重項	名詞
ｲﾁｼﾞｭｳｺｳｼﾞｮｳﾀｲ	一重項状態	名詞
ｲﾁｼﾞｭｳｾﾝ	一重線	名詞
ｲﾄﾏﾘｼﾞｮｳｺｳﾌﾞﾝｼ	糸まり状高分子	名詞
ｲｯﾀｲｷﾝｼﾞ	一体近似	名詞
ｲｯﾀｲﾎﾟﾃﾝｼｬﾙ	一体ポテンシャル	名詞
ｲｯﾁﾖｳﾕｳ	一致溶融	名詞
ｲﾖｳﾃﾞﾝｼｺｳｶﾞｸ	医用電子工学	名詞
ｲﾕｳｺﾞｳｷﾝ	易融合金	名詞
ｲｼﾞﾝｸﾞﾓｹｲ	イジング模型	名詞
ｲｼﾞｮｳﾌﾞﾝｻﾝ	異常分散	名詞
ｲｼﾞｮｳﾃﾞﾝｷﾃｲｺｳ	異常電気抵抗	名詞
ｲｼﾞｮｳﾃﾞﾝﾊﾟﾝ	異常伝搬	名詞
ｲｼﾞｮｳｴｷﾀｲ	異常液体	名詞
ｲｼﾞｮｳｷﾞﾝｼ	異常g因子	名詞
ｲｼﾞｮｳｸﾞﾛｰﾎｳﾃﾞﾝ	異常グロー放電	名詞
ｲｼﾞｮｳﾊ	異常波	名詞
ｲｼﾞｮｳﾋﾈﾂ	異常比熱	名詞
ｲｼﾞｮｳﾎｰﾙｺｳｶ	異常ホール効果	名詞
ｲｼﾞｮｳﾋｮｳﾋｺｳｶ	異常表皮効果	名詞
ｲｼﾞｮｳｶｸｻﾝ	異常拡散	名詞
ｲｼﾞｮｳｹｲﾚﾂ	異常系列	名詞
ｲｼﾞｮｳｹｯｼｮｳﾘｭｳ	異常結晶粒	名詞
ｲｼﾞｮｳｺｳｾﾝ	異常光線	名詞
ｲｼﾞｮｳｼｷｲﾁ	異常しきい値	名詞
ｲｼﾞｮｳﾄｳｶ	異常透過	名詞
ｲｼﾞｮｳｾﾞｰﾏﾝｺｳｶ	異常ゼーマン効果	名詞
ｲｼﾞｮｳｼﾞｹﾞﾝ	異常次元	名詞
ｲｼﾞｮｳｼﾞｷﾓｰﾒﾝﾄ	異常磁気モーメント	名詞
ｲｼﾞｭｳｺｳｶﾝｾﾝｲ	異重項間遷移	名詞
ｲｼﾞｮｳｺｳｶﾝｾﾝｲｾﾝ	異重項間遷移線	名詞
ｼﾞS	JIS	名詞
JｰJｹﾂｺﾞｳ	j-j結合	名詞
JｰJｹﾂｺﾞｳｶｸﾓｹｲ	j-j結合殻模型	名詞
Jﾌﾟｻｲﾘｭｳｼ	J/ψ粒子	名詞
Jﾌﾟｻｲﾘｭｳｼ	J/$\psi$粒子	名詞
Jﾌﾟｻｲﾘｭｳｼ	J/\psi粒子	名詞
Kﾃﾞﾝｼﾎｶｸ	K電子捕獲	名詞
KDPﾓｹｲ	KDP模型	名詞
KDVﾎｳﾃｲｼｷ	KdV方程式	名詞
Kｷﾞｮｳﾚﾂ	K行列	名詞
Kﾁｭｳｶﾝｼｹﾞﾝｼ	K中間子原子	名詞
ｶﾍﾞﾃｲｺｳﾌｱﾝﾃｲｾｲ	壁抵抗不安定性	名詞
ｶﾋﾞﾎﾞｶｸ	カビボ角	名詞
ｶｰﾌﾞﾄﾚｰｻｰ	カーブトレーサー	名詞
ｶﾃﾞﾝｱﾂ	過電圧	名詞
ｶﾃﾞﾝﾋﾞﾝｶﾝｿﾞｳﾌｸｷ	荷電敏感増幅器	名詞
ｶﾃﾞﾝﾄﾞｸﾘﾂｾｲ	荷電独立性	名詞
ｶﾃﾞﾝﾍﾝｶﾝﾆｭｳｼｬ	荷電変換入射	名詞
ｶﾃﾞﾝｶﾚﾝﾄ	荷電カレント	名詞
ｶﾃﾞﾝｺｳｶﾝ	荷電交換	名詞
ｶﾃﾞﾝｺｳｶﾝﾊﾝﾉｳ	荷電交換反応	名詞
ｶﾃﾞﾝｺｳｶﾝﾎﾟﾃﾝｼｬﾙ	荷電交換ポテンシャル	名詞
ｶﾃﾞﾝｸｳｶﾝ	荷電空間	名詞
ｶﾃﾞﾝｷｮｳﾔｸﾍﾝｶﾝ	荷電共役変換	名詞
ｶﾃﾞﾝﾘｭｳ	過電流	名詞
ｶﾃﾞﾝﾘｭｼ	荷電粒子	名詞
ｶﾃﾞﾝｼ	価電子	名詞
ｶﾃﾞﾝｼﾀｲ	価電子帯	名詞
ｶﾃﾞﾝｼｼﾞｮｳﾀｲ	価電子状態	名詞
ｶﾃﾞﾝｽﾋﾟﾝ	荷電スピン	名詞
ｶﾃﾞﾝﾀｲｼｮｳｾｲ	荷電対称性	名詞
ｶﾄﾞｳｺｲﾙﾃﾞﾝﾘｭｳｹｲ	可動コイル電流計	名詞
ｶﾄﾞﾐｳﾑﾋ	カドミウム比	名詞
ｶｴﾝﾎｳﾃﾞﾝ	火炎放電	名詞
ｶｶﾞｸﾌﾞﾂﾘｶﾞｸ	化学物理学	名詞
ｶｶﾞｸﾊｯｺｳ	化学発光	名詞
ｶｶﾞｸﾊﾝﾉｳ	化学反応	名詞
ｶｶﾞｸﾍｲｺｳ	化学平衡	名詞
ｶｶﾞｸｲｵﾝｶ	化学イオン化	名詞
ｶｶﾞｸｶﾝﾜﾎｳ	化学緩和法	名詞
ｶｶﾞｸｶｿｸｷ	化学加速器	名詞
ｶｶﾞｸｹﾂｺﾞｳ	化学結合	名詞
ｶｶﾞｸｷｭｳﾁｬｸ	化学吸着	名詞
ｶｶﾞｸﾎﾟﾃﾝｼｬﾙ	化学ポテンシャル	名詞
ｶｶﾞｸﾚｵﾛｼﾞｰ	化学レオロジー	名詞
ｶｶﾞｸﾚｰｻﾞｰ	化学レーザー	名詞
ｶｶﾞｸﾘｮｳﾛﾝ	化学量論	名詞
ｶｶﾞｸﾘｮｳﾛﾝｾｲ	化学量論性	名詞
ｶｶﾞｸｻﾖｳ	化学作用	名詞
ｶｶﾞｸｾﾝﾘｮｳｹｲ	化学線量計	名詞
ｶｶﾞｸｼﾌﾄ	化学シフト	名詞
ｶｶﾞｸｼﾝﾄｳｾﾂ	化学浸透説	名詞
ｶｶﾞｸｼﾝﾜﾘｮｸ	化学親和力	名詞
ｶｶﾞｸﾃｷﾌﾞﾝﾘﾎｳ	化学的分離法	名詞
ｶｶﾞｸﾃｷﾎｳｼｬｾﾝｺｳｶ	化学的放射線効果	名詞
ｶｶﾞｸﾃｷｾﾝﾘｮｳ	化学的線量	名詞
ｶｶﾞｸﾃﾝﾋﾞﾝ	化学てんびん	名詞
ｶｶﾞｸﾄｳﾘｮｳ	化学当量	名詞
ｶｶﾞｸｼﾞｮｳﾁｬｸ	化学蒸着	名詞
ｶｹﾞﾝｽｲ	過減衰	名詞
ｶｹﾞﾝｽｲｶｲﾛ	過減衰回路	名詞
ｶｹﾞﾝﾃｲｺｳｷ	加減抵抗器	名詞
ｶｹﾞｻﾝﾗﾝ	影散乱	名詞
ｶｺﾞｳﾌﾞﾂﾊﾝﾄﾞｳﾀｲ	化合物半導体	名詞
ｶｺﾞｳﾌﾞﾂｹｲ	化合物系	名詞
ｶｷﾞｬｸﾃﾞﾝﾁ	可逆電池	名詞
ｶｷﾞｬｸﾍﾝｶ	可逆変化	名詞
ｶｷﾞｬｸﾌﾘｺ	可逆振り子	名詞
ｶｷﾞｬｸｶｲﾛ	可逆回路	名詞
ｶｷﾞｬｸｶﾃｲ	可逆過程	名詞
ｶｷﾞｬｸｷｶﾝ	可逆機関	名詞
ｶｷﾞｬｸｻｲｸﾙ	可逆サイクル	名詞
ｶｷﾞｬｸｿｼ	可逆素子	名詞
ｶﾍﾝｺﾝﾃﾞﾝｻｰ	可変コンデンサー	名詞
ｶﾍﾝﾘｰｸﾍﾞﾝ	可変リーク弁	名詞
ｶﾍﾝﾘｮｳｲｷﾎｯﾋﾟﾝｸﾞ	可変領域ホッピング	名詞
ｶﾍﾝﾃｲｺｳｷ	可変抵抗器	名詞
ｶﾍﾝﾖｳﾘｮｳﾀﾞｲｵｰﾄﾞ	可変容量ダイオード	名詞
ｶﾍﾝｿﾞｳﾌｸｶﾝ	可変増幅管	名詞
ｶﾎｳｶﾃｲ	加法過程	名詞
ｶﾎｳｺﾝｼｮｸ	加法混色	名詞
ｶﾎｳｾｲ	加法性	名詞
ｶﾎｳﾜ	過飽和	名詞
ｶﾎｳﾜｺﾖｳﾀｲ	過飽和固溶体	名詞
ｶﾌｶ	過負荷	名詞
ｶｲﾀﾞﾝｺｳｼ	階段格子	名詞
ｶｲｴｲ	回映	名詞
ｶｲｴｲﾀｲｼｮｳ	回映対称	名詞
ｶｲｴｲｼﾞｸ	回映軸	名詞
ｶｲﾊﾝ	回反	名詞
ｶｲﾊﾝﾀｲｼｮｳ	回反対称	名詞
ｶｲﾊﾝｼﾞｸ	回反軸	名詞
ｶｲﾊﾝﾀｲｼｮｳｼﾞｸ	回反対称軸	名詞
ｶｲﾍｲｷ	開閉器	名詞
ｶｲﾍﾝ	壊変	名詞
ｶｲﾎｳｶﾞﾀXｾﾝｶﾝ	開放型X線管	名詞
ｶｲﾎｳｹｲ	解放系	名詞
ｶｲﾎｳﾀﾝ	解放端	名詞
ｶｲﾎｳﾀﾝｹｲ	解放端系	名詞
ｶｲﾌｸｼﾞｶﾝ	回復時間	名詞
ｶｲｲ	回位	名詞
ｶｲｶｸ	開殻	名詞
ｶｲｶｸｶｸ	開殻核	名詞
ｶｲｶﾝ	開管	名詞
ｶｲｷﾌﾞﾝｾｷ	回帰分析	名詞
ｶｲｺｳｺﾞｳｾｲ	開口合成	名詞
ｶｲｺｳｽｳ	開口数	名詞
ｶｲｺｳﾀﾝ	開口端	名詞
ｶｲｺｳﾀﾝﾎｾｲ	開口端補正	名詞
ｶｲﾒﾝﾃﾞﾝｲ	界面電位	名詞
ｶｲﾒﾝﾃﾞﾝｷｹﾞﾝｼｮｳ	界面電気現象	名詞
ｶｲﾒﾝﾄﾞｳﾃﾞﾝｹﾞﾝｼｮｳ	界面動電現象	名詞
ｶｲﾒﾝﾄﾞｳﾃﾞﾝｲ	界面動電位	名詞
ｶｲﾒﾝｴﾈﾙｷﾞｰ	界面エネルギー	名詞
ｶｲﾒﾝﾁｮｳﾘｮｸ	界面張力	名詞
ｶｲﾒﾝｼﾞｭｳｺﾞｳ	界面重合	名詞
ｶｲﾗﾘﾃｨ	カイラリティ	名詞
ｶｲﾗﾙﾀﾞｲﾅﾐｯｸｽ	カイラルダイナミックス	名詞
ｶｲﾘｱﾂ	解離圧	名詞
ｶｲﾘﾄﾞ	解離度	名詞
ｶｲﾘｴﾈﾙｷﾞｰ	解離エネルギー	名詞
ｶｲﾘｹﾞﾝｶｲ	解離限界	名詞
ｶｲﾘﾍｲｺｳ	解離平衡	名詞
ｶｲﾘｶｸｻﾝ	解離拡散	名詞
ｶｲﾘｷｭｳﾁｬｸ	解離吸着	名詞
ｶｲﾘﾚﾝｿﾞｸｽﾍﾟｸﾄﾙ	解離連続スペクトル	名詞
ｶｲﾘｾｲﾃﾞﾝﾘ	解離性電離	名詞
ｶｲﾘｾｲﾌﾁｬｸ	解離性付着	名詞
ｶｲﾘｾｲｻｲｹﾂｺﾞｳ	解離性再結合	名詞
ｶｲﾘﾃｲｽｳ	解離定数	名詞
ｶｲﾛｹｲ	回路計	名詞
ｶｲﾛﾓｳ	回路網	名詞
ｶｲﾛｿｼ	回路素子	名詞
ｶｲﾙｰﾌﾟｾｲｷﾞｮ	開ループ制御	名詞
ｶｲｾｷﾍﾞｸﾄﾙ	解析ベクトル	名詞
ｶｲｾｷｶﾝｽｳ	解析関数	名詞
ｶｲｾｷﾘｷｶﾞｸ	解析力学	名詞
ｶｲｾｷｾｲ	解析性	名詞
ｶｲｾｷｾﾂｿﾞｸ	解析接続	名詞
ｶｲｾｷﾃｷｶｲ	解析的解	名詞
ｶｲｾｷﾃｷｶｲﾎｳ	解析的解法	名詞
ｶｲｾｷﾃｷｾﾂﾄﾞｳﾛﾝ	解析的摂動論	名詞
ｶｲｾﾂ	回折	名詞
ｶｲｾﾂﾊ	回折波	名詞
ｶｲｾﾂｶｲﾘ	回折解離	名詞
ｶｲｾﾂｶｸ	回折角	名詞
ｶｲｾﾂｶﾝｽｳ	回折関数	名詞
ｶｲｾﾂｹｲ	回折計	名詞
ｶｲｾﾂｺﾝﾄﾗｽﾄ	回折コントラスト	名詞
ｶｲｾﾂｺｳﾘﾂ	回折効率	名詞
ｶｲｾﾂｺｳｼ	回折格子	名詞
ｶｲｾﾂｺｳｼﾉｼｷ	回折格子の式	名詞
ｶｲｾﾂｷｭｳｼｭｳ	回折吸収	名詞
ｶｲｾﾂﾘﾛﾝ	回折理論	名詞
ｶｲｾﾂｻﾝﾗﾝ	回折散乱	名詞
ｶｲｾﾂｿﾞｳ	回折像	名詞
ｶｲﾃﾝﾌﾞﾝｻﾝ	回転分散	名詞
ｶｲﾃﾝﾀﾞｴﾝﾀｲ	回転だ円体	名詞
ｶｲﾃﾝﾀﾞｴﾝﾀｲ	回転楕円体	名詞
ｶｲﾃﾝﾄﾞｳﾆｭｳｷ	回転導入器	名詞
ｶｲﾃﾝｴﾈﾙｷﾞｰ	回転エネルギー	名詞
ｶｲﾃﾝｸﾞﾝ	回転群	名詞
ｶｲﾃﾝｷﾞｮｳﾚﾂ	回転行列	名詞
ｶｲﾃﾝﾊﾝｹｲ	回転半径	名詞
ｶｲﾃﾝﾊﾝﾃﾝ	回転反転	名詞
ｶｲﾃﾝﾍﾝｶﾝ	回転変換	名詞
ｶｲﾃﾝﾍﾝｶﾝｶｸ	回転変換角	名詞
ｶｲﾃﾝﾍﾝｺｳ	回転偏光	名詞
ｶｲﾃﾝﾍﾝﾘｭｳｷ	回転変流機	名詞
ｶｲﾃﾝﾋﾈﾂ	回転比熱	名詞
ｶｲﾃﾝﾌﾍﾝｾｲ	回転不変性	名詞
ｶｲﾃﾝｲｾｲ	回転異性	名詞
ｶｲﾃﾝｲｾｲﾀｲ	回転異性体	名詞
ｶｲﾃﾝｶｲｼﾞｶﾞﾀﾓｰﾀｰ	回転界磁型モーター	名詞
ｶｲﾃﾝｶｸ	回転角	名詞
ｶｲﾃﾝｶﾝﾜ	回転緩和	名詞
ｶｲﾃﾝｹｲ	回転計	名詞
ｶｲﾃﾝｹｯｼｮｳﾎｳ	回転結晶法	名詞
ｶｲﾃﾝｹﾂｺﾞｳ	回転結合	名詞
ｶｲﾃﾝｺｳ	回転項	名詞
ｶｲﾃﾝｺｳｿﾞｳ	回転構造	名詞
ｶｲﾃﾝｷｮｳｴｲ	回転鏡映	名詞
ｶｲﾃﾝﾈﾝﾄﾞｹｲ	回転粘度計	名詞
ｶｲﾃﾝｵﾝﾄﾞ	回転温度	名詞
ｶｲﾃﾝﾚｲｷ	回転励起	名詞
ｶｲﾃﾝﾘｮｳｼｽｳ	回転量子数	名詞
ｶｲﾃﾝﾘｭｳﾀｲ	回転流体	名詞
ｶｲﾃﾝｾﾝｲ	回転遷移	名詞
ｶｲﾃﾝｾﾂﾄﾞｳ	回転摂動	名詞
ｶｲﾃﾝｼ	回転子	名詞
ｶｲﾃﾝｼｷﾌﾗﾝｼﾞ	回転式フランジ	名詞
ｶｲﾃﾝｼﾝﾄﾞｳﾊﾞﾝﾄﾞ	回転振動バンド	名詞
ｶｲﾃﾝｼﾝﾄﾞｳｹﾂｺﾞｳ	回転-振動結合	名詞
ｶｲﾃﾝｿｳﾃﾝｲ	回転相転移	名詞
ｶｲﾃﾝｽﾍﾟｸﾄﾙ	回転スペクトル	名詞
ｶｲﾃﾝﾀｲ	回転帯	名詞
ｶｲﾃﾝﾀｲｼｮｳ	回転対称	名詞
ｶｲﾃﾝﾃｲｽｳ	回転定数	名詞
ｶｲﾃﾝｳﾝﾄﾞｳ	回転運動	名詞
ｶｲﾃﾝｳﾝﾄﾞｳｴﾈﾙｷﾞｰ	回転運動エネルギー	名詞
ｶｲﾃﾝｻﾞﾋｮｳ	回転座標	名詞
ｶｲﾃﾝｻﾞﾋｮｳｹｲ	回転座標系	名詞
ｶｲﾃﾝｼﾞﾊﾞ	回転磁場	名詞
ｶｲﾃﾝｼﾞｶｲ	回転磁界	名詞
ｶｲﾃﾝｼﾞｸ	回転軸	名詞
ｶｲﾃﾝｼﾞｭﾝｲ	回転準位	名詞
ｶｲｻﾞｰ	カイザー	名詞
ｶｲｼﾞ	界磁	名詞
ｶｲｼﾞｼｬｸ	界磁石	名詞
ｶｲｿﾞｳﾘｮｸ	解像力	名詞
ｶｲｼﾞｮｳｼﾞｭｳｺﾞｳ	塊状重合	名詞
ｶｲｼﾞｭｳｺﾞｳ	解重合	名詞
ｶｶｲ	下界	名詞
ｶｶﾝｸﾞﾝ	可換群	名詞
ｶｶﾝ	可換	名詞
ｶｶﾝｼｮｳｾｲ	可干渉性	名詞
ｶｶﾝｼｮｳｼﾞｶﾝ	可干渉時間	名詞
ｶｰｹﾝﾄﾞｰﾙｺｳｶ	カーケンドール効果	名詞
ｶｺｳﾌｸﾃﾝ	下降伏点	名詞
ｶｰｺｳｶ	カー効果	名詞
ｶｺｳｼﾞｶﾝ	下降時間	名詞
ｶｸﾌﾞﾝｺｳｶﾞｸ	核分光学	名詞
ｶｸﾌﾞﾝﾌﾟ	角分布	名詞
ｶｸﾌﾞﾝﾚﾂ	核分裂	名詞
ｶｸﾌﾞﾝﾚﾂﾃﾞﾝﾘﾊﾞｸ	核分裂電離箱	名詞
ｶｸﾌﾞﾝﾚﾂﾍﾝ	核分裂片	名詞
ｶｯｸﾌﾞﾝﾚﾂｲｾｲﾀｲ	核分裂異性体	名詞
ｶｸﾌﾞﾝﾚﾂｹｲｽｳｶﾝ	核分裂計数管	名詞
ｶｸﾌﾞﾝﾚﾂﾉｼｭｳﾘﾂ	核分裂の収率	名詞
ｶｸﾌﾞﾝﾚﾂﾚﾝｻﾊﾝﾉｳ	核分裂連鎖反応	名詞
ｶｸﾌﾞﾝﾚﾂｾｲﾌﾞｯｼﾂ	核分裂性物質	名詞
ｶｸﾌﾞﾝﾚﾂｾｲｶｸｼｭ	核分裂性核種	名詞
ｶｸﾌﾞﾝﾚﾂｾｲｾｲﾌﾞﾂ	核分裂生成物	名詞
ｶｸﾌﾞﾝﾚﾂｼｮｳﾍｷ	核分裂障壁	名詞
ｶｸﾌﾞﾝﾚﾂﾁｭｳｾｲｼ	核分裂中性子	名詞
ｶｸﾌﾞﾝｻﾝ	角分散	名詞
ｶｸﾌﾞﾂﾘ	核物理	名詞
ｶｸﾀﾞﾝﾈﾂｼｮｳｼﾞ	核断熱消磁	名詞
ｶｸﾄﾞﾌﾞﾝﾌﾟ	角度分布	名詞
ｶｸﾄﾞｿｳｶﾝ	角度相関	名詞
ｶｸﾄﾞｼﾞｮｳｷﾞ	角度定規	名詞
ｶｸｹﾞﾝﾘｮｳﾌﾞｯｼﾂ	核原料物質	名詞
ｶｸｺﾞｳｾｲ	核合成	名詞
ｶｸﾊﾝｹｲ	核半径	名詞
ｶｸﾊﾝﾉｳｼｭｳﾘｮｳ	核反応収量	名詞
ｶｸﾊｻｲ	核破砕	名詞
ｶｸﾍﾝｹｲ	核変形	名詞
ｶｸﾍﾝｽｳ	角変数	名詞
ｶｸｲｾｲﾀｲ	核異性体	名詞
ｶｸｶｲﾃﾝ	核回転	名詞
ｶｸｶﾝｷｮﾘ	核間距離	名詞
ｶｸｶｿｸﾄﾞ	角加速度	名詞
ｶｸｺｳｿﾞｳ	核構造	名詞
ｶｸｺｳｿﾞｳ	殻構造	名詞
ｶｸｷｮｳﾒｲｹｲｺｳ	核共鳴蛍光	名詞
ｶｸﾏｸﾊﾞﾙﾌﾞ	隔膜バルブ	名詞
ｶｸﾏｸｼﾝｸｳｹｲ	隔膜真空系	名詞
ｶｸﾓｹｲ	殻模型	名詞
ｶｸﾓｰﾒﾝﾄ	核モーメント	名詞
ｶｸﾆﾝｹﾞﾝｶｲ	確認限界	名詞
ｶｸﾉﾍﾝｹｲ	核の変形	名詞
ｶｸﾉｶｲﾃﾝ	核の回転	名詞
ｶｸﾉｶﾝｾｲﾓｰﾒﾝﾄ	核の慣性モーメント	名詞
ｶｸﾉｵﾝﾄﾞ	核の温度	名詞
ｶｸﾉｼﾝﾄﾞｳ	核の振動	名詞
ｶｸｵﾝﾄﾞ	核温度	名詞
ｶｸﾎﾟﾃﾝｼｬﾙ	核ポテンシャル	名詞
ｶｸﾚｲｷｬｸ	核冷却	名詞
ｶｸﾚｲﾄｳ	核冷凍	名詞
ｶｸﾚﾀﾍﾝｽｳ	隠れた変数	名詞
ｶｸﾘﾂﾋﾞﾌﾞﾝ	確率微分	名詞
ｶｸﾘﾂﾋﾞﾌﾞﾝﾎｳﾃｲｼｷ	確率微分方程式	名詞
ｶｸﾘﾂﾌﾞﾝﾌﾟ	確率分布	名詞
ｶｸﾘﾂｺﾞｻ	確率誤差	名詞
ｶｸﾘﾂｷﾞｮｳﾚﾂ	確率行列	名詞
ｶｸﾘﾂﾍﾝｽｳ	確率変数	名詞
ｶｸﾘﾂｶｲｼｬｸ	確率解釈	名詞
ｶｸﾘﾂｶﾃｲ	確率過程	名詞
ｶｸﾘﾂｶﾃｲﾘｮｳｼｶ	確率過程量子化	名詞
ｶｸﾘﾂﾐﾂﾄﾞ	確率密度	名詞
ｶｸﾘﾂﾉﾎｿﾞﾝ	確率の保存	名詞
ｶｸﾘﾂﾉﾅｶﾞﾚ	確率の流れ	名詞
ｶｸﾘﾂﾚｲｷｬｸ	確率冷却	名詞
ｶｸﾘﾂｾｷﾌﾞﾝ	確率積分	名詞
ｶｸﾘﾂｼﾝﾌﾟｸ	確率振幅	名詞
ｶｸﾘﾂｼﾞｼｮｳ	確率事象	名詞
ｶｸﾘｮｸ	核力	名詞
ｶｸｻﾝﾀﾞﾝﾒﾝｾｷ	拡散断面積	名詞
ｶｸｻﾝﾃﾞﾝﾘｭｳ	拡散電流	名詞
ｶｸｻﾝﾊﾝｼｬ	拡散反射	名詞
ｶｸｻﾝﾎｳﾃｲｼｷ	拡散方程式	名詞
ｶｸｻﾝﾋｮｳﾒﾝ	拡散表面	名詞
ｶｸｻﾝｶﾃｲ	拡散過程	名詞
ｶｸｻﾝｹｲｽｳ	拡散係数	名詞
ｶｸｻﾝｺｳ	拡散光	名詞
ｶｸｻﾝｷｮﾘ	拡散距離	名詞
ｶｸｻﾝｵﾝ	拡散音	名詞
ｶｸｻﾝﾎﾟﾝﾌﾟ	拡散ポンプ	名詞
ｶｸｻﾝﾗﾝ	核散乱	名詞
ｶｸｻﾝﾘｯｿｸﾃｲｼ	拡散律速停止	名詞
ｶｸｻﾝﾘﾂ	拡散率	名詞
ｶｸｻﾝｾﾂｺﾞｳ	拡散接合	名詞
ｶｸｻﾝｿｸﾄﾞ	拡散速度	名詞
ｶｸｻﾝｿｳ	拡散層	名詞
ｶｸｾｲﾚﾂ	核整列	名詞
ｶｸｾｲｾｲ	核生成	名詞
ｶｸｼ	核子	名詞
ｶｸｼｲｺｳﾊﾝﾉｳ	核子移行反応	名詞
ｶｸｼｶｽｹｰﾄﾞ	核子カスケード	名詞
ｶｸｼｷｮｸｷｮｳﾒｲ	核四極共鳴	名詞
ｶｸｼｷｮｸｼｷｮｳｲﾒｲ	核四極子共鳴	名詞
ｶｸｼｷｮｸﾓｰﾒﾝﾄ	核四極モーメント	名詞
ｶｸｼｷｮｸｼﾓｰﾒﾝﾄ	核四極子モーメント	名詞
ｶｸｼﾝﾄﾞｳ	核振動	名詞
ｶｸｼﾝﾄﾞｳｽｳ	角振動数	名詞
ｶｸｿｳｶﾝ	角相関	名詞
ｶｸｿｸﾄﾞ	角速度	名詞
ｶｸｼｭ	核種	名詞
ｶｸｼｭｳﾊｽｳ	角周波数	名詞
ｶｸﾃｲﾄｸｲﾃﾝ	確定特異点	名詞
ｶｸﾃｷｿｼﾉｳ	核的阻止能	名詞
ｶｸﾃﾝｶﾝ	核転換	名詞
ｶｸﾁｮｳﾋｭｯｹﾙﾎｳ	拡張ヒュッケル法	名詞
ｶｸﾁｮｳｻﾚﾀｿﾞｰﾝ	拡張されたゾーン	名詞
ｶｸﾁｮｳﾃﾝｲ	拡張転位	名詞
ｶｰｸｳｯﾄﾞﾗｲｽﾞﾏﾝ	カークウッド・ライズマン	人名
ﾈﾝﾄﾞｼｷ	粘度式	名詞
ｶｸｳﾝﾄﾞｳﾘｮｳ	角運動量	名詞
ｶｸｳﾝﾄﾞｳﾘｮｳｴﾝｻﾞﾝｼ	角運動量演算子	名詞
ｶｸｳﾝﾄﾞｳﾘｮｳﾎｿﾞﾝｿｸ	角運動量保存則	名詞
ｶｸｳﾝﾄﾞｳﾘｮｳﾎｿﾞﾝ	角運動量保存	名詞
ｶｸｳﾝﾄﾞｳﾘｮｳｲｺｳ	角運動量移行	名詞
ｺﾞｳｾｲｿｸ	合成則	名詞
ｶｸｳﾝﾄﾞｳﾘｮｳｼｮｳﾍｷ	角運動量障壁	名詞
ｶｸﾕｳｺﾞｳﾊﾝﾉｳ	核融合反応	名詞
ｶｸﾕｳｺﾞｳﾛ	核融合炉	名詞
ｶｸｼﾞｷ	核磁気	名詞
ｶｸｼﾞｷｶﾝﾜ	核磁気緩和	名詞
ｶｸｼﾞｷｷｮｳﾒｲ	核磁気共鳴	名詞
ｶｸｼﾞｷﾓｰﾒﾝﾄ	核磁気モーメント	名詞
ｶｸｼﾞｷﾕｳﾄﾞｳ	核磁気誘導	名詞
ｶｸｼﾞｾｲ	核磁性	名詞
ｶｸｼﾞｼ	核磁子	名詞
ｶｸｫｰｸ	価クォーク	名詞
ｶｰﾏ	カーマ	名詞
ｶﾒﾝ	火面	名詞
ｶﾅﾓﾘｷﾝｼﾞ	金森近似	名詞
ｶﾅｼｷ	金敷	名詞
ｶﾝｱﾂﾄﾗﾝｼﾞｽﾀｰ	感圧トランジスター	名詞
ｶﾝﾋﾞｾｲ	完備性	名詞
ｶﾝﾃﾞﾝﾘｭｳ	環電流	名詞
ｶﾝﾃﾞﾗ	カンデラ	名詞
ｶﾈﾂﾀﾞﾂｶﾞｽ	加熱脱ガス	名詞
ｶﾈﾂｺｳﾘﾂ	加熱効率	名詞
ｶﾈﾂｼﾞｮｳｷ	過熱蒸気	名詞
ｶﾝｹﾞﾝﾊｽｳ	還元波数	名詞
ｶﾝｹﾞﾝﾊｽｳｲｷ	還元波数域	名詞
ｶﾝｹﾞﾝﾈﾝﾄﾞ	還元粘度	名詞
ｶﾝｹﾞﾝﾘｮｳｲｷﾎｳｼｷ	還元領域方式	名詞
ｶﾆｾｲｳﾝ	かに星雲	名詞
ｶﾝｶｸｷｿｸ	間隔規則	名詞
ｶﾝｹｲｼｷ	関係式	名詞
ｶﾝｺｳｾｲｼﾞｭｼ	感光性樹脂	名詞
ｶﾝｺｳｻﾞｲﾘｮｳ	感光材料	名詞
ｶﾝｷｮｳﾎｳｼｬｾﾝ	環境放射線	名詞
ｶﾝｷｮｳｵｳﾘｮｸｷﾚﾂ	環境応力亀裂	名詞
ｶﾝｷｮｳｼｹﾝ	環境試験	名詞
ｶﾝﾒﾝｿﾞｳ	完面像	名詞
ｶﾝﾅｲﾊﾁｮｳ	管内波長	名詞
ｶﾝｵﾝｿｼ	感音素子	名詞
ｶｰﾉｼﾞｸｳ	カーの時空	名詞
ｶﾝｻﾝｷﾞｮｳﾚﾂﾖｳｿ	換算行列要素	名詞
ｶﾝｻﾝﾊﾊﾞ	換算幅	名詞
ｶﾝｻﾝｵｳﾘｮｸ	換算応力	名詞
ｶﾝｻﾝｾﾝｲｶｸﾘﾂ	換算遷移確率	名詞
ｶﾝｻﾝｼﾂﾘｮｳ	換算質量	名詞
ｶﾝｻﾝｿｸ	換算則	名詞
ｶﾝｾｲﾀﾞｴﾝﾀｲ	慣性楕円体	名詞
ｶﾝｾｲﾀﾞｴﾝﾀｲ	慣性だ円体	名詞
ｶﾝｾｲｶｸﾕｳｺﾞｳ	慣性核融合	名詞
ｶﾝｾｲｹｲ	慣性系	名詞
ｶﾝｾｲｹｲｽｳ	慣性係数	名詞
ｶﾝｾｲﾓｰﾒﾝﾄ	慣性モーメント	名詞
ｶﾝｾｲﾉﾎｳｿｸ	慣性の法則	名詞
ｶﾝｾｲﾘｮｸ	慣性力	名詞
ｶﾝｾｲｼﾂﾘｮｳ	慣性質量	名詞
ｶﾝｾｲｼｭｼﾞｸ	慣性主軸	名詞
ｶﾝｾｲﾃｲｺｳ	慣性抵抗	名詞
ｶﾝｾｲﾃﾝｿﾙ	慣性テンソル	名詞
ｶﾝｾｲﾄｼﾞｺﾒ	慣性閉込め	名詞
ｶﾝｾｲｻﾞﾋｮｳｹｲ	慣性座標系	名詞
ｶﾝｾｲｼﾞｮｳｾｷ	慣性乗積	名詞
ｶﾝｾﾂｷﾞｬｯﾌﾟ	間接ギャップ	名詞
ｶﾝｾﾂｺｳｶﾝｿｳｺﾞｻﾖｳ	間接交換相互作用	名詞
ｶﾝｾﾂｾﾝｲ	間接遷移	名詞
ｶﾝｾﾂｿｸﾃｲ	間接測定	名詞
ｶﾝｼﾂｷｭｳｼﾂﾄﾞｹｲ	乾湿球湿度計	名詞
ｶﾝｿｳﾀﾞﾝﾈﾂｹﾞﾝﾘﾂ	乾燥断熱減率	名詞
ｶﾝｿｸﾎｳﾃｲｼｷ	観測方程式	名詞
ｶﾝｿｸﾉﾘﾛﾝ	観測の理論	名詞
ｶﾝｿｸﾘｮｳ	観測量	名詞
ｶﾝｽｳﾊｯｾｲｷ	関数発生器	名詞
ｶﾝｽｳｷﾝｼﾞ	関数近似	名詞
ｶﾝｼｮｳﾌﾞﾝｺｳｷ	干渉分光器	名詞
ｶﾝｼｮｳﾌｨﾙﾀｰ	干渉フィルター	名詞
ｶﾝｼｮｳｹﾝﾋﾞｷｮｳ	干渉顕微鏡	名詞
ｶﾝｼｮｸｾｲ	感色性	名詞
ｶﾝｼｮｳﾉｼﾞｽｳ	干渉の次数	名詞
ｶﾝｼｮｳｾｲ	干渉性	名詞
ｶﾝｼｮｳｾｲ	干渉性	連体詞
ｶﾝｼｮｳｾｲｻﾝﾗﾝ	干渉性散乱	名詞
ｶﾝｼｮｳｼｮｸ	干渉色	名詞
ｶﾝｼｮｳﾁｮｳ	干渉長	名詞
ｶﾝｼｮｳﾖｳｴｷ	緩衝溶液	名詞
ｶﾝｼｮｳｼﾞﾏ	干渉じま	名詞
ｶﾝｼｮｳｿﾞｳﾌｸｷ	緩衝増幅器	名詞
ｶﾝﾜﾀﾞﾝｾｲﾘﾂ	緩和弾性率	名詞
ｶﾝﾜｹﾞﾝｼｮｳ	緩和現象	名詞
ｶﾝﾜﾊｯｼﾝ	緩和発振	名詞
ｶﾝﾜｶﾃｲ	緩和過程	名詞
ｶﾝﾜｼﾝﾄﾞｳ	緩和振動	名詞
ｶﾝﾜｽﾍﾟｸﾄﾙ	緩和スペクトル	名詞
ｶﾝﾜｼﾞｶﾝ	緩和時間	名詞
ｶﾝｾﾞﾝﾀﾞﾝｾｲ	完全弾性	名詞
ｶﾝｾﾞﾝﾀﾞﾝｾｲｼｮｳﾄﾂ	完全弾性衝突	名詞
ｶﾝｾﾞﾝﾀﾞﾝｾｲﾀｲ	完全弾性体	名詞
ｶﾝｾﾞﾝﾀﾞﾝｿｾｲﾀｲ	完全弾塑性体	名詞
ｶﾝｾﾞﾝﾄﾞｳﾃﾞﾝｾｲ	完全導電性	名詞
ｶﾝｾﾞﾝﾄﾞｳﾀｲ	完全導体	名詞
ｶﾝｾﾞﾝﾊﾝｼﾞｾｲ	完全反磁性	名詞
ｶﾝｾﾞﾝﾍﾝｺｳ	完全偏光	名詞
ｶﾝｾﾞﾝﾋﾀﾞﾝｾｲｼｮｳﾄﾂ	完全非弾性衝突	名詞
ｶﾝｾﾞﾝｹｲ	完全系	名詞
ｶﾝｾﾞﾝｹｯｼｮｳ	完全結晶	名詞
ｶﾝｾﾞﾝｾｲｷﾁｮｯｺｳｹｲ	完全正規直交系	名詞
ｶﾝｾﾞﾝﾃﾝｲ	完全転位	名詞
ｶﾝｾﾞﾝｼﾞｯｹﾝ	完全実験	名詞
ｶﾝｼﾞｮｳﾃﾞﾝﾘｭｳ	環状電流	名詞
ｶﾝｼﾞｮｳﾎｳﾃﾞﾝ	環状放電	名詞
ｶﾝｼﾞｮｳｼﾞﾊﾞ	環状磁場	名詞
ｶﾝｼﾞｭﾘﾂ	感受率	名詞
ｶｵｽ	カオス	名詞
ｶﾋﾟｯﾂｧﾃｲｺｳ	カピッツァ抵抗	名詞
ｶﾋﾟｯﾂｱﾃｲｺｳ	カピッツァ抵抗	名詞
ｶｯﾌﾟﾗｰ	カップラー	名詞
ｶﾗｰﾎﾛｸﾞﾗﾑ	カラーホログラム	名詞
ｶﾗﾐｱｲ	からみ合い	名詞
ｶﾗﾝｼﾞﾏﾝﾂｨｸﾎｳﾃｲｼｷ	カラン・ジマンツィク方程式	名詞
ｶﾚｲ	過冷	名詞
ｶﾚｲｷｬｸ	過冷却	名詞
ｶﾚﾝﾄ	カレント	名詞
ｶﾚﾝﾄﾀﾞｲｽｳ	カレント代数	名詞
ｶﾘｰﾌﾟﾛｯﾄ	カリープロット	名詞
ｶﾛﾘｯｸｾﾂ	カロリック説	名詞
ｶﾛﾘﾒｰﾀｰ	カロリメーター	名詞
ｶﾛﾘﾒﾄﾘｰ	カロリメトリー	名詞
ｶﾛﾁﾉｲﾄﾞ	カロチノイド	名詞
ｶﾙﾋﾞﾝｻｲｸﾙ	カルビンサイクル	名詞
ｶｰﾙﾊｳﾌﾟﾄﾏﾝ	カール・ハウプトマン	人名
ｶﾙｺｹﾞﾅｲﾄﾞｶﾗｽ	カルコゲナイドガラス	名詞
ｶﾙﾏﾝﾌｨﾙﾀｰ	カルマンフィルター	名詞
ｶﾙﾏﾝ	カルマン	人名
ｾﾝｵﾝｿｸｿｳｼﾞﾎｳｿｸ	遷音速相似法則	名詞
ｶﾙﾏﾝﾁｪﾝﾉｷﾝｼﾞ	カルマン・チェンの近似	名詞
ｶﾙﾏﾝｳｽﾞﾚﾂ	カルマン渦列	名詞
ｶﾙﾉｰ	カルノー	人名
ｶﾙﾉｰ	Carnot	人名
ｶﾙﾉｰｺｳﾘﾂ	カルノー効率	名詞
ｶﾙﾉｰﾉﾃｲﾘ	カルノーの定理	名詞
ｶﾙﾉｰｻｲｸﾙ	カルノーサイクル	名詞
ｶﾙｰﾂｧｸﾗｲﾝﾘﾛﾝ	カルーツァ・クライン理論	名詞
ｶｻﾅﾘﾉﾃﾞﾝｼｽｳ	重なりの電子数	名詞
ｶｻﾅﾘｾｷﾌﾞﾝ	重なり積分	名詞
ｶｻﾈｱﾜｾﾉｹﾞﾝﾘ	重ね合せの原理	名詞
ｶｻﾝｶｲﾛ	加算回路	名詞
ｶｾｸﾞﾚﾝｼｮｳﾃﾝ	カセグレン焦点	名詞
ｶｾｷﾈﾝﾘｮｳ	化石燃料	名詞
ｶｰｾﾙ	カーセル	名詞
ｶｾﾄﾒｰﾀｰ	カセトメーター	名詞
ｶｼﾄﾞ	カ氏度	名詞
ｶｼｶ	可視化	名詞
ｶｼｺｳ	可視光	名詞
ｶｼｺｳｾﾝ	可視光線	名詞
ｶｼﾐｰﾙｴﾝｻﾞﾝｼ	カシミール演算子	名詞
ｶｼﾚｰｻﾞｰ	可視レーザー	名詞
ｶｼｼｶﾞｲ	可視紫外	名詞
ｶｼｽﾍﾟｸﾄﾙ	可視スペクトル	名詞
ｶｿｳﾌﾞﾝｼｷﾄﾞｳ	仮想分子軌道	名詞
ｶｿｳﾌﾞﾝｼｷﾄﾞｳｶﾝｽｳ	仮想分子軌道関数	名詞
ｶｿｰﾄﾞ	カソード	名詞
ｶｿｰﾄﾞﾎﾛｰﾜｰ	カソードホローワー	名詞
ｶｿｳｴﾈﾙｷﾞｰｼﾞｭﾝｲ	仮想エネルギー準位	名詞
ｶｿｳﾍﾝｲﾉｹﾞﾝﾘ	仮想変位の原理	名詞
ｶｿｳｲﾝｷｮｸ	仮想陰極	名詞
ｶｿｳｶﾃｲ	仮想過程	名詞
ｶｿｳｺｳｼ	仮想光子	名詞
ｶｿｸﾃﾞﾝｱﾂ	加速電圧	名詞
ｶｿｸﾃﾞﾝｷｮｸ	加速電極	名詞
ｶｿｸﾄﾞｹｲ	加速度計	名詞
ｶｿｸﾄﾞﾎﾟﾃﾝｼｬﾙ	加速度ポテンシャル	名詞
ｶｿｸｶﾝ	加速管	名詞
ｶｿｸｷ	加速器	名詞
ｶｿｸｷｶｶﾞｸ	加速器科学	名詞
ｶｿｸｷｿﾞｳｼｮｸ	加速器増殖	名詞
ｶｿｸｸｳﾄﾞｳ	加速空洞	名詞
ｶｿｳﾉｶﾃｲ	仮想の過程	名詞
ｶｿｾｲ	可塑性	名詞
ｶｿｳｾﾝｲ	仮想遷移	名詞
ｶｿｳｾｯﾁ	仮想接地	名詞
ｶｿｳｼｺﾞﾄ	仮想仕事	名詞
ｶｿｳｼｺﾞﾄﾉｹﾞﾝﾘ	仮想仕事の原理	名詞
ｶｿｳｼﾂﾘｮｳ	仮想質量	名詞
ｶｿｳｿｸﾊﾞｸｼﾞｮｳﾀｲ	仮想束縛状態	名詞
ｶｿｳｽﾋﾟﾝﾘｮｳｼｽｳ	仮想スピン量子数	名詞
ｶｿｳﾁｭｳｶﾝｼ	仮想中間子	名詞
ｶｿｳｳﾝﾄﾞｳﾘｮｳ	仮想運動量	名詞
ｶｿｳｼﾞｮｳﾀｲ	仮想状態	名詞
ｶｯｾｲｶｴﾈﾙｷﾞｰ	活性化エネルギー	名詞
ｶｯｾｲｶﾈﾂ	活性化熱	名詞
ｶｯｾｲｶﾀｲｾｷ	活性化体積	名詞
ｶｯｾｲｻｸﾀｲ	活性錯体	名詞
ｶｯｾｲｻｸｺﾞｳﾀｲ	活性錯合体	名詞
ｶｯｾｲﾁｭｳｼﾝ	活性中心	名詞
ｶｽｲﾌﾞﾝｶｲ	加水分解	名詞
ｶｽｹｰﾄﾞｴｷｶﾎｳ	カスケード液化法	名詞
ｶｽｹｰﾄﾞﾍﾝｱﾂｷ	カスケード変圧器	名詞
ｶｽｹｰﾄﾞﾎｳｼｬ	カスケード放射	名詞
ｶｽｹｰﾄﾞｶﾃｲ	カスケード過程	名詞
ｶｽｹｰﾄﾞｾﾂｿﾞｸ	カスケード接続	名詞
ｶｽｹｰﾄﾞｼｬﾜｰ	カスケードシャワー	名詞
ｶｽｹｰﾄﾞﾕﾆｯﾄ	カスケードユニット	名詞
ｶｽｹｰﾄﾞｿﾞｳﾌｸｷ	カスケード増幅器	名詞
ｶｽﾌﾟｼﾞﾊﾞ	カスプ磁場	名詞
ｶｽﾃｨﾘｱﾉﾉﾃｲﾘ	カスティリアノの定理	名詞
ｶｰｽﾄｻﾞｰﾊﾞｰﾉｼｷ	カースト・ザーバーの式	名詞
ｶｽｳﾖｳﾄﾞｳ	価数揺動	名詞
ｶﾀｲｸｻﾘ	かたい鎖	名詞
ｶﾀﾑｷﾉﾁｭｼﾝ	傾きの中心	名詞
ｶﾀｻｹｲ	硬さ計	名詞
ｶﾀｽﾄﾛﾌｨｰ	カタストロフィー	名詞
ｶﾀﾕﾚﾓｰﾒﾝﾄ	かたゆれモーメント	名詞
ｶﾄ	過渡	名詞
ｶﾄｹﾞﾝｼｮｳ	過渡現象	名詞
ｶﾄﾍｲｺｳ	過渡平衡	名詞
ｶﾄｺｽｷｰﾉｷｿｸ	カトコスキーの規則	名詞
ｶﾄｵｳｵﾄｳ	過渡応答	名詞
ｶﾄｳﾚﾘｯﾋﾉﾃｲﾘ	加藤・レリッヒの定理	名詞
ｶﾄｼﾝﾄﾞｳ	過渡振動	名詞
ｶｯﾄｺｱ	カットコア	名詞
ｶｯﾄｵﾌ	カットオフ	名詞
ｶﾂﾄﾞｳﾃﾞﾝｲ	活動電位	名詞
ｶﾂﾄﾞｳﾄﾞ	活動度	名詞
ｶﾂﾄﾞｳﾄﾞｹｲｽｳ	活動度係数	名詞
ｶﾂﾘｮｳ	活量	名詞
ｶﾂﾘｮｳｹｲｽｳ	活量係数	名詞
ｶﾁｮｳｵﾝ	可聴音	名詞
ｶﾁｮｳｼｭｳﾊ	可聴周波	名詞
ｶﾁｮｳｼｭｳﾊｽｳ	可聴周波数	名詞
ｶｳﾝﾀｰﾎﾄﾞｽｺｰﾌﾟ	カウンターホドスコープ	名詞
ｶｳﾘｰﾑｰﾃﾞｨｰ	カウリー・ムーディー	人名
ﾄﾞｳﾘｷｶﾞｸﾃｷﾘﾛﾝ	動力学的理論	名詞
ｶﾜｷﾄﾞ	乾き度	名詞
ｶﾜｷﾎｳﾜｼﾞｮｳｷ	乾き飽和蒸気	名詞
ｶﾕｳｶｲ	過融解	名詞
ｶｿﾞｳ	仮像	名詞
ｶｼﾞｮｳｶﾝｾﾞﾝｹｲ	過剰完全系	名詞
ｹﾌｪｳｽｻﾞﾃﾞﾙﾀｶﾞﾀ	ケフェウス座δ型	名詞
ｹﾌｪｳｽｻﾞﾃﾞﾙﾀｶﾞﾀ	ケフェウス座$\delta$型	名詞
ｹﾌｪｳｽｻﾞﾃﾞﾙﾀｶﾞﾀ	ケフェウス座\delta型	名詞
ｹｲﾃﾞﾝｷ	継電器	名詞
ｹｲｲｷﾞ	経緯儀	名詞
ｹｲｶｸﾘｭｳｶｲ	傾角粒界	名詞
ｹｲｶｸｽﾋﾟﾝｺｳｿﾞｳ	傾角スピン構造	名詞
ｹｲｹﾝｵﾝﾄﾞ	経験温度	名詞
ｹｲｺｳﾊﾞﾝ	蛍光板	名詞
ｹｲｺｳﾌﾞﾝｺｳｺｳﾄﾞｹｲ	蛍光分光光度計	名詞
ｹｲｺｳﾌﾞﾝｾｷ	蛍光分析	名詞
ｹｲｺｳｽﾍﾟｸﾄﾙ	蛍光スペクトル	名詞
ｹｲｺｳｼｭｳﾘｮｳ	蛍光収量	名詞
ｹｲｺｳXｾﾝ	蛍光X線	名詞
ｹｲｺｳXｾﾝﾌﾞﾝｾｷ	蛍光X線分析	名詞
ｹｲﾚﾂﾉｷｮｸｹﾞﾝ	系列の極限	名詞
ｹｲﾛｾｷﾌﾞﾝ	経路積分	名詞
ｹｲﾘｮｳｿｳﾁ	計量装置	名詞
ｹｲﾘｮｳﾃﾝｿﾙ	計量テンソル	名詞
ｹｲｻﾝｺﾞｻ	計算誤差	名詞
ｹｲｻﾝｶﾉｳｾｲ	計算可能性	名詞
ｹｲｻﾝｷﾀﾞﾝｿｳｻﾂｴｲﾎｳ	計算機断層撮影法	名詞
ｹｲｻﾝｷﾎﾛｸﾞﾗﾑ	計算機ホログラム	名詞
ｹｲｻﾝｷｾｲｷﾞｮ	計算機制御	名詞
ｹｲｻﾝｷｼﾞｯｹﾝ	計算機実験	名詞
ｹｲｻﾝﾘｮｳ	計算量	名詞
ｹｲｽｳｶｲﾛ	計数回路	名詞
ｹｲｽｳｶﾝ	計数管	名詞
ｹｲｽｳｷ	計数器	名詞
ｹｲｽｳﾘﾂｹｲ	計数率計	名詞
ｹｲｽｳｿｳﾁ	計数装置	名詞
ｹｲｼｬｶﾝｱﾂﾘｮｸｹｲ	傾斜管圧力計	名詞
ｹｲｼｬｹｲ	傾斜計	名詞
ｹｲｼｬｹｲｽｳ	傾斜係数	名詞
ｹｲﾄｳｺﾞｻ	系統誤差	名詞
ｹｲﾄｳﾃｷﾄﾞｳｼﾞﾊﾝｼｬ	系統的同時反射	名詞
ｹｲｼﾞｮｳｱｲｿﾏｰ	形状アイソマー	名詞
ｹｲｼﾞｮｳｲﾎｳｾｲ	形状異方性	名詞
ｹｲｼﾞｮｳｲﾝｼ	形状因子	名詞
ｹｲｼﾞｮｳｷｵｸｺﾞｳｷﾝ	形状記憶合金	名詞
ｹｲｼﾞｮｳｷｵｸｺｳｶ	形状記憶効果	名詞
ｹｲｼﾞｮｳｷｮｳﾒｲ	形状共鳴	名詞
ｹｲｼﾞｮｳﾃｲｺｳ	形状抵抗	名詞
ｹｯｶﾝｼﾞｭﾝｲ	欠陥準位	名詞
ｼﾞｭﾝｲ	準位	名詞
ｹﾝﾋﾞﾌﾞﾝｺｳｿｸｺｳﾎｳ	顕微分光測光法	名詞
ｹﾝﾋﾞｷｮｳﾀｲﾌﾞﾂﾚﾝｽﾞ	顕微鏡対物レンズ	名詞
ｹﾝﾋﾞﾗﾏﾝﾌﾞﾝｺｳ	顕微ラマン分光	名詞
ｹﾝﾀﾞｸｴｷ	懸濁液	名詞
ｹﾝﾃﾞﾝｷ	検電器	名詞
ｹﾝｺｳﾊﾞﾝ	検光板	名詞
ｹﾝｺｳｼ	検光子	名詞
ｹﾝﾈﾂ	顕熱	名詞
ｹﾝﾊﾟｷ	検波器	名詞
ｹﾝﾘｭｹｲ	検流計	名詞
ｹﾝｼｭﾂｹﾞﾝｶｲ	検出限界	名詞
ｹﾝﾄｳｹｲ	検糖計	名詞
ｹﾌﾟﾗｰﾉﾎｳｿｸ	ケプラーの法則	名詞
ｹﾌﾟﾗｰｳﾝﾄﾞｳ	ケプラー運動	名詞
ｹﾌﾟｽﾄﾗﾑ	ケプストラム	名詞
ｹﾙﾋﾞﾝ	Kelvin	人名
ｹﾙﾋﾞﾝﾍﾙﾑﾎﾙﾂ	ケルビン・ヘルムホルツ	人名
ｹﾙﾋﾞﾝﾎｳ	ケルビン法	名詞
ｹﾙﾋﾞﾝﾓｹｲ	ケルビン模型	名詞
ｹﾙﾋﾞﾝﾉｼﾞｭﾝｶﾝﾃｲﾘ	ケルビンの循環定理	名詞
ｹﾙﾋﾞﾝｵﾝﾄﾞ	ケルビン温度	名詞
ｹｯｾﾝ	欠線	名詞
ｹｯｼｮｳﾊﾞ	結晶場	名詞
ｹｯｼｮｳﾊﾞﾘﾛﾝ	結晶場理論	名詞
ｹｯｼｮｳﾌﾞﾝｻﾝ	結晶分散	名詞
ｹｯｼｮｳﾀﾞﾝｾｲﾘﾂ	結晶弾性率	名詞
ｹｯｼｮｳﾄﾞ	結晶度	名詞
ｹｯｼｮｳｶﾞｲｹｲｲﾝｼ	結晶外形因子	名詞
ｹｯｼｮｳｶﾞｸ	結晶学	名詞
ｹｯｼｮｳｸﾞﾝ	結晶群	名詞
ｹｯｼｮｳﾋｷｱｹﾞﾎｳ	結晶引上げ法	名詞
ｹｯｼｮｳﾎｳｲ	結晶方位	名詞
ｹｯｼｮｳｶﾄﾞ	結晶化度	名詞
ｹｯｼｮｳｹｲ	結晶形	名詞
ｹｯｼｮｳｹｲ	結晶系	名詞
ｹｯｼｮｳｷﾄﾞｳ	結晶軌道	名詞
ｹｯｼｮｳｺｳｶﾞｸ	結晶光学	名詞
ｹｯｼｮｳｺｳｼ	結晶格子	名詞
ｹｯｼｮｳｺｳｿﾞｳ	結晶構造	名詞
ｹｯｼｮｳｺｳｿﾞｳｲﾝｼ	結晶構造因子	名詞
ｹｯｼｮｳﾘｭｳ	結晶粒	名詞
ｹｯｼｮｳｾｲｺｳﾌﾞﾝｼ	結晶性高分子	名詞
ｹｯｼｮｳｾｲﾘｭｳｷ	結晶整流器	名詞
ｹｯｼｮｳｾｲﾁｮｳ	結晶成長	名詞
ｹｯｼｮｳｿｼｷ	結晶組織	名詞
ｹｯｼｮｳｽｲ	結晶水	名詞
ｹｯｼｮｳﾃﾝｸﾞﾝ	結晶点群	名詞
ｹｯｼｮｳﾄｳｴｲﾎｳ	結晶投影法	名詞
ｹｯｼｮｳﾄｳｹｲ	結晶統計	名詞
ｹｯｼｮｳｳﾝﾄﾞｳﾘｮｳ	結晶運動量	名詞
ｹｯｼｮｳｼﾞｷｲﾎｳｾｲ	結晶磁気異方性	名詞
ｹｯｼｮｳｼﾞｸ	結晶軸	名詞
ｹｽﾀｰｽｶﾝｼｮｳｹｲ	ケスタース干渉計	名詞
ｹｰﾀｰﾉｶｷﾞｬｸﾌﾘｺ	ケーターの可逆振り子	名詞
ｹﾂｴｷﾚｵﾛｼﾞｰ	血液レオロジー	名詞
ｹﾂｺﾞｳｴﾈﾙｷﾞｰ	結合エネルギー	名詞
ｹﾂｺﾞｳﾍﾝｾｲｷ	結合変成器	名詞
ｹﾂｺﾞｳｶｸ	結合角	名詞
ｹﾂｺﾞｳｹｲｽｳ	結合係数	名詞
ｹﾂｺﾞｳｷﾄﾞｳ	結合軌道	名詞
ｹﾂｺﾞｳｺｳﾀｲ	結合交代	名詞
ｹﾂｺﾞｳｷｮｳﾒｲ	結合共鳴	名詞
ｹﾂｺﾞｳｷｮﾘ	結合距離	名詞
ｹﾂｺﾞｳﾓｰﾒﾝﾄ	結合モーメント	名詞
ｹﾂｺﾞｳﾉﾅｶﾞｻ	結合の長さ	名詞
ｹﾂｺﾞｳｵﾝ	結合音	名詞
ｹﾂｺﾞｳｾｲﾀﾞﾂﾘ	結合性脱離	名詞
ｹﾂｺﾞｳｾｲﾃﾞﾝﾘ	結合性電離	名詞
ｹﾂｺﾞｳｾｲｲｵﾝｶ	結合性イオン化	名詞
ｹﾂｺﾞｳｾｲｷﾄﾞ	結合性軌道	名詞
ｹﾂｺﾞｳｷﾄﾞｳｶﾝｽｳ	結合軌道関数	名詞
ｹﾂｺﾞｳｾｲｷﾄﾞｳｶﾝｽｳ	結合性軌道関数	名詞
ｹﾂｺﾞｳｾﾂﾀﾞﾝｴﾈﾙｷﾞｰ	結合切断エネルギー	名詞
ｹﾂｺﾞｳﾃｲｽｳ	結合定数	名詞
ｹﾂｺﾞｳｼﾞｽｳ	結合次数	名詞
ｹﾂｿﾞｳ	結像	名詞
ｷｱﾂｿｯｺｳﾎｳ	気圧測高法	名詞
ｷﾃﾞﾝｱﾂ	起電圧	名詞
ｷﾃﾞﾝｼｼﾞｮｳﾀｲ	奇電子状態	名詞
ｷﾄﾞｳﾃﾞﾝｼ	軌道電子	名詞
ｷﾄﾞｳﾊﾝｼﾞｾｲ	軌道反磁性	名詞
ｷﾄﾞﾍﾝﾁｮｳ	輝度変調	名詞
ｷﾄﾞｳｶｲｾｷ	軌道解析	名詞
ｷﾄﾞｳｶｸｳﾝﾄﾞｳﾘｮｳ	軌道角運動量	名詞
ｷﾄﾞｳｶﾝｽｳ	軌道関数	名詞
ｷﾄﾞｳｷﾄﾞｳｿｳｺﾞｻﾖｳ	軌道-軌道相互作用	名詞
ｷﾄﾞｳｷﾄﾞｳｶﾝ	軌道-軌道間	名詞
ｷﾄﾞｳｺﾝｾｲ	軌道混成	名詞
ｷﾄﾞｵﾝﾄﾞ	輝度温度	名詞
ｷﾄﾞﾙｲ	希土類	名詞
ｷﾄﾞﾙｲｹﾞﾝｿ	希土類元素	名詞
ｷﾄﾞﾙｲｶｸ	希土類核	名詞
ｷﾄﾞｳｼｭｳﾊｽｳ	軌道周波数	名詞
ｷﾄﾞｳﾀｲｼﾞﾘﾂ	軌道帯磁率	名詞
ｷﾄﾞｳﾖｳｿ	軌道要素	名詞
ｷﾄﾞｳｼﾞｷﾓｰﾒﾝﾄ	軌道磁気モーメント	名詞
ｷﾄﾞｳｼﾞｮｳｼﾞｾｲ	軌道常磁性	名詞
ｷｶﾞｽ	希ガス	名詞
ｷｸﾞｳｶｸ	奇偶核	名詞
ｼﾞｮｳｼﾞｾｲ	常磁性	名詞
ｷｸﾞｳｺｳｶ	奇偶効果	名詞
ｷﾊｸｷﾀｲ	希薄気体	名詞
ｷﾊｸﾖｳｴｷ	希薄溶液	名詞
ｷﾊｸｼﾞｾｲｺﾞｳｷﾝ	希薄磁性合金	名詞
ｷﾍﾝﾄﾞ	起偏度	名詞
ｷﾎｳｶﾞﾀﾉﾀﾞｲﾔｸﾞﾗﾑ	気泡型のダイヤグラム	名詞
ｷﾎﾝﾍﾞｸﾄﾙ	基本ベクトル	名詞
ｷﾎﾝｹｲﾚﾂ	基本系列	名詞
ｷﾎﾝｺｳｼ	基本格子	名詞
ｷﾎﾝｵﾝ	基本音	名詞
ｷﾎﾝﾘｭｳｼ	基本粒子	名詞
ｷﾎﾝｼﾝﾄﾞｳ	基本振動	名詞
ｷﾎﾝｼﾝﾄﾞｳｽｳ	基本振動数	名詞
ｷﾎﾝﾀﾝｲ	基本単位	名詞
ｷﾎﾝﾃｲﾃﾝ	基本定点	名詞
ｷﾎﾝﾃﾝｿﾙ	基本テンソル	名詞
ｷｶｶﾞｸﾃｷﾀﾞﾝﾒﾝｾｷ	幾何学的断面積	名詞
ｷｶｶﾞｸﾃｷｷｮｳﾒｲ	幾何学的共鳴	名詞
ｷｶｲﾃﾞﾝｷﾍﾝｶﾝ	機械電気変換	名詞
ｷｶｲｴﾈﾙｷﾞｰ	機械エネルギー	名詞
ｷｶｲｺｸｾﾝｶｲｾﾂｺｳｼ	機械刻線回折格子	名詞
ｷｶｲｾｲ	幾何異性	名詞
ｷｶｺｳｶﾞｸ	幾何光学	名詞
ｷｶｸｶｴﾐｯﾀﾝｽ	規格化エミッタンス	名詞
ｷｶｸｶｺｳｿﾞｳｲﾝｼ	規格化構造因子	名詞
ｷｶｸｶｾｷﾌﾞﾝ	規格化積分	名詞
ｷｶﾝｲﾝﾋﾟｰﾀﾞﾝｽ	帰還インピーダンス	名詞
ｷｶﾝﾘﾂ	帰還率	名詞
ｷｶﾝｿﾞｳﾌｸｷ	帰還増幅器	名詞
ｷｷｶｸ	奇奇核	名詞
ｷｯｶｰﾃﾞﾝｼﾞｼｬｸ	キッカー電磁石	名詞
ｷｺｳ	奇項	名詞
ｷｺｳﾘﾂ	気孔率	名詞
ｷｸﾁﾊﾞﾝﾄﾞ	菊池バンド	名詞
ｷｸﾁｾﾝ	菊池線	名詞
ｷｸﾁｽﾞｹｲ	菊池図形	名詞
ｷﾒﾗ	キメラ	名詞
ｷﾆｰｶﾞﾀｶｲﾃﾝﾎﾟﾝﾌﾟ	キニー型回転ポンプ	名詞
ｷﾝｲﾂﾊﾊﾞ	均一幅	名詞
ｷﾝｸ	キンク	名詞
ｷﾝｸﾌｱﾝﾃｲｾｲ	キンク不安定性	名詞
ｷﾝｷｮﾘｵﾝﾊﾞ	近距離音場	名詞
ｷﾝｷｮﾘﾘｮｸ	近距離力	名詞
ｷﾝｷｮﾘｿｳｺﾞｻﾖｳ	近距離相互作用	名詞
ｷﾝﾐﾂｹﾂｺﾞｳﾎｳ	緊密結合法	名詞
ｷﾉｳｹﾂｺﾞｳｶﾞﾀ	機能結合型	名詞
ｷﾝｾｲﾊﾞﾝﾄﾞ	禁制バンド	名詞
ｷﾝｾｲﾊﾝｼｬ	禁制反射	名詞
ｷﾝｾｲｾﾝ	禁制線	名詞
ｷﾝｾｷｶﾞｲｾﾝ	近赤外線	名詞
ｷﾝｾｷｶﾞｲｽﾍﾟｸﾄﾙ	近赤外スペクトル	名詞
ｷﾝｾﾂｺｳｶ	近接効果	名詞
ｷﾝｾﾂﾚﾝｾｲ	近接連星	名詞
ｷﾝｾﾂｻﾖｳ	近接作用	名詞
ｷﾝｾﾂｼｮｳﾄﾂ	近接衝突	名詞
ｷﾝｼﾍﾞｰﾀﾎｳｶｲ	禁止β崩壊	名詞
ｷﾝｼﾍﾞｰﾀﾎｳｶｲ	禁止$\beta$崩壊	名詞
ｷﾝｼﾍﾞｰﾀﾎｳｶｲ	禁止\beta崩壊	名詞
ｷﾝｼｾﾝｲ	禁止遷移	名詞
ｷﾝｼﾀｲ	禁止帯	名詞
ｷﾝｼﾂ	均質化	名詞
ｷﾝｼﾂｹｲ	均質系	名詞
ｷﾝｼﾔｿﾞｳ	近視野像	名詞
ｷﾝｼﾞｶｲ	近似解	名詞
ｷﾝｼﾞｸｺｳｾﾝ	近軸光線	名詞
ｷﾝｼﾞﾂﾃﾝｲﾄﾞｳ	近日点移動	名詞
ｷﾝｿﾞｸﾋﾞﾘｭｳｼ	金属微粒子	名詞
ｷﾝｿﾞｸﾃﾞﾝｼﾛﾝ	金属電子論	名詞
ｷﾝｿﾞｸｶﾞｸ	金属学	名詞
ｷﾝｿﾞｸｹﾞﾝｼｶ	金属原子価	名詞
ｷﾝｿﾞｸﾊｸﾏｸ	金属薄膜	名詞
ｷﾝｿﾞｸﾏｸﾃｲｺｳｷ	金属膜抵抗器	名詞
ｷﾝｿﾞｸﾋﾏｸﾃｲｺｳｷ	金属皮膜抵抗	名詞
ｷﾝｿﾞｸｶﾝｶｺﾞｳﾌﾞﾂ	金属間化合物	名詞
ｷﾝｿﾞｸｹﾝﾋﾞｷｮｳ	金属顕微鏡	名詞
ｷﾝｿﾞｸｹｯｼｮｳ	金属結晶	名詞
ｷﾝｿﾞｸｹﾂｺﾞｳ	金属結合	名詞
ｷﾝｿﾞｸｾﾞﾂｴﾝﾀｲﾃﾝｲ	金属-絶縁体転移	名詞
ｷﾝｿﾞｸｼﾞｮｳｷﾚｰｻﾞｰ	金属蒸気レーザー	名詞
ｷｵｸｺｳｶ	記憶効果	名詞
ｷｵﾝ	気音	名詞
ｷﾚﾂｼﾝﾃﾝﾘｮｸ	亀裂進展力	名詞
ｷﾘﾊﾞｺ	霧箱	名詞
ｷﾘｶｸｺｳｶ	切欠効果	名詞
ｷﾘﾝｸﾞﾎｳﾃｲｼｷ	キリング方程式	名詞
ｷﾛｸﾞﾗﾑｼﾞｭｳ	キログラム重	名詞
ｷﾙﾋﾎｯﾌ	キルヒホッフ	人名
ｷﾙﾋﾎｯﾌ	Kirchhoff	人名
ｷﾙﾋﾎｯﾌﾉﾎｳｿｸ	キルヒホッフの法則	名詞
ｷﾙﾋﾎｯﾌﾉﾎｳｼｬﾎｳｿｸ	キルヒホッフの放射法則	名詞
ｷﾙﾋﾎｯﾌﾉｶｲｾﾂﾘﾛﾝ	キルヒホッフの回折理論	名詞
ｷｻ	器差	名詞
ｷｾｲﾊｯｼﾝ	寄生発振	名詞
ｷｾｲｷｮｳｼﾞｾｲ	寄生強磁性	名詞
ｷｾﾉﾝﾗﾝﾌﾟ	キセノンランプ	名詞
ｷｾﾝｾｲｳﾝ	輝線星雲	名詞
ｷｾﾝｽﾍﾟｸﾄﾙ	輝線スペクトル	名詞
ｷｼﾂ	基質	名詞
ｷｿｳ	気相	名詞
ｷｿｸﾄﾞ	規則度	名詞
ｷｿｸｺﾞｳｷﾝ	規則合金	名詞
ｷｿｸｺｳｼ	規則格子	名詞
ｷｿｷｭｼｭｳ	基礎吸収	名詞
ｷｿｳｾｲﾁｮｳ	気相成長	名詞
ｷｿｳｾﾝ	気相線	名詞
ｷｼｬｸﾈﾂ	希釈熱	名詞
ｷｼｬｸﾚｲﾄｳｷ	希釈冷凍機	名詞
ｷﾀｲﾌﾞﾝｼｳﾝﾄﾞｳﾛﾝ	気体分子運動論	名詞
ｷﾀｲﾃﾞﾝﾘ	気体電離	名詞
ｷﾀｲﾊｲｷﾌﾞﾂ	気体廃棄物	名詞
ｷﾀｲﾊﾝﾉｳﾉﾎｳｿｸ	気体反応の法則	名詞
ｷﾀｲﾎｳﾃﾞﾝ	気体放電	名詞
ｷﾀｲｵﾝﾄﾞｹｲ	気体温度計	名詞
ｷﾀｲﾚｰｻﾞｰ	気体レーザー	名詞
ｷﾀｲﾘｷｶﾞｸ	気体力学	名詞
ｷﾀｲｼﾝﾁﾚｰﾀｰ	気体シンチレーター	名詞
ｷﾀｲﾃｲｽｳ	気体定数	名詞
ｷﾀｲｿﾞｳﾌｸ	気体増幅	名詞
ｷﾃｲｱﾂ	基底圧	名詞
ｷﾃｲｼﾞｮｳﾀｲ	基底状態	名詞
ｷﾃｲｼﾞｮｳﾀｲｿｳｶﾝ	基底状態相関	名詞
ｷﾁｮｳﾘｮｸ	起潮力	名詞
ｷﾁｭｳ	気柱	名詞
ｷﾔｸ	既約	連体詞
ｷﾔｸﾋｮｳｹﾞﾝ	既約表現	名詞
ｷﾔｸｸﾗｽﾀｰｾｷﾌﾞﾝ	既約クラスター積分	名詞
ｷﾔｸﾃﾝｿﾙ	既約テンソル	名詞
ｷｼﾞﾘｮｸ	起磁力	名詞
ｷｼﾞｭﾝﾓｰﾄﾞ	基準モード	名詞
ｷｼﾞｭﾝﾈﾂｷﾃﾞﾝﾘｮｸ	規準熱起電力	名詞
ｷｼﾞｭﾝｼﾝﾄﾞｳ	基準振動	名詞
ｷｼﾞｭﾝｻﾞﾋｮｳ	基準座標	名詞
ｺｱﾍﾝｷｮｸ	コア偏極	名詞
ｺｱﾚｾﾝｽﾓｹｲ	コアレセンス模型	名詞
ｺｱｾﾙﾍﾞｰﾄ	コアセルベート	名詞
ｺｳｱﾂﾌﾞﾂﾘｶﾞｸ	高圧物理学	名詞
ｺｳｱﾂﾃﾞﾝｼｿｳﾃﾝｲ	高圧電子相転移	名詞
ｺｳｱﾂｹｲ	高圧計	名詞
ｺﾊﾞﾔｼﾏｽｶﾜﾓｹｲ	小林・益川模型	名詞
ｺﾍﾞﾂﾚｲｷ	個別励起	名詞
ｺﾍﾞﾂﾂﾘｱｲ	個別釣合い	名詞
ｺｳﾌﾞﾝｶｲﾉｳ	高分解能	名詞
ｺｳﾌﾞﾝｼﾌﾞﾂﾘｶﾞｸ	高分子物理学	名詞
ｺｳﾌﾞﾝｼﾃﾞﾝｶｲｼﾂ	高分子電解質	名詞
ｺｳﾌﾞﾝｼｴｷｼｮｳ	高分子液晶	名詞
ｺｳﾌﾞﾝｼﾊﾝﾄﾞｳﾀｲ	高分子半導体	名詞
ｺｳﾌﾞﾝｼｹｯｼｮｳ	高分子結晶	名詞
ｺｳﾌﾞﾝｼｺｳｶ	高分子効果	名詞
ｺｳﾌﾞﾝｼｻｸﾀｲ	高分子錯体	名詞
ｺｳﾌﾞﾝｼﾖｳｴｷ	高分子溶液	名詞
ｺｳﾀﾞﾝｾｲｺｳｶ	光弾性効果	名詞
ｺｳﾀﾞﾝｾｲ	高弾性	名詞
ｺｳﾀﾞﾝｾｲ	光弾性	名詞
ｺｳｱﾂ	光圧	名詞
ｺｳﾃﾞﾝﾄﾞｳ	光伝導	名詞
ｺｳﾃﾞﾝﾄﾞｳｾﾙ	光伝導セル	名詞
ｺｳﾃﾞﾝｹﾞﾝｶｲﾊﾁｮｳ	香典限界波長	名詞
ｺｳﾃﾞﾝﾍﾝｶﾝ	光電変換	名詞
ｺｳﾃﾞﾝｲﾝｷｮｸ	光電陰極	名詞
ｺｳﾃﾞﾝｺｳｶ	光電効果	名詞
ｺｳﾃﾞﾝｷｭｳｼｭｳ	光電吸収	名詞
ｺｳﾃﾞﾝﾘｲｵﾝ	高電離イオン	名詞
ｺｳﾃﾞﾝﾘｭｳ	光電流	名詞
ｺｳﾃﾞﾝｼ	光電子	名詞
ｺｳﾃﾞﾝｼﾌﾞﾝｺｳﾎｳ	光電子分光法	名詞
ｺｳﾃﾞﾝｼﾎｳｼｭﾂ	光電子放出	名詞
ｺｳﾃﾞﾝｼｿﾞｳﾊﾞｲｶﾝ	光電子増倍管	名詞
ｺｳﾄﾞｳ	黄道	名詞
ｺｰﾄﾞﾍﾝｶﾝ	コード変換	名詞
ｺﾄﾞﾎｳ	弧度法	名詞
ｺｳﾄﾞｹｲ	光度計	名詞
ｺｳﾄﾞｳｺｳ	黄道光	名詞
ｺｳｴﾝ	紅炎	名詞
ｺｳｴﾈﾙｷﾞｰﾌﾞﾂﾘｶﾞｸ	高エネルギー物理学	名詞
ｺｳｴﾝｽｲ	光円錐	名詞
ｺｳｶﾞｸﾀﾞｲ	光学台	名詞
ｺｳｶﾞｸｶﾞﾗｽ	光学ガラス	名詞
ｺｳｶﾞｸﾊｸﾏｸ	光学薄膜	名詞
ｺｳｶﾞｸｲｾｲ	光学異性	名詞
ｺｳｶﾞｸｲｾｲﾀｲ	光学異性体	名詞
ｺｳｶﾞｸｶｯｾｲ	光学活性	名詞
ｺｳｶﾞｸｹｲ	光学系	名詞
ｺｳｶﾞｸｹﾝﾋﾞｷｮｳ	光学顕微鏡	名詞
ｺｳｶﾞｸｺﾝﾊﾞｰﾀｰ	光学コンバーター	名詞
ｺｳｶﾞｸｸｻﾋﾞ	光学くさび	名詞
ｺｳｶﾞｸﾐﾂﾄﾞ	光学密度	名詞
ｺｳｶﾞｸﾓｰﾄﾞ	光学モード	名詞
ｺｳｶﾞｸﾓｹｲ	光学模型	名詞
ｺｳｶﾞｸﾉｳﾄﾞ	光学濃度	名詞
ｺｳｶﾞｸﾎﾟﾃﾝｼｬﾙ	光学ポテンシャル	名詞
ｺｳｶﾞｸﾀﾝｲｹｲ	工学単位系	名詞
ｺｳｶﾞｸﾃｲﾘ	光学定理	名詞
ｺｳｶﾞｸﾃｲｽｳ	光学定数	名詞
ｺｳｶﾞｸﾃｷｱﾂｻ	光学的厚さ	名詞
ｺｳｶﾞｸﾃｷﾃﾞﾝﾀﾂｶﾝｽｳ	光学的伝達関数	名詞
ｺｳｶﾞｸﾃｷﾋｽﾞﾐ	光学的ひずみ	名詞
ｺｳｶﾞｸﾃｷﾌｶｻ	光学的深さ	名詞
ｺｳｶﾞｸﾃｷｷﾝｾｲｾﾝｲ	光学的禁制遷移	名詞
ｺｳｶﾞｸﾃｷｷｮﾖｳｾﾝｲ	光学的許容遷移	名詞
ｺｳｶﾞｸﾃｷﾏｯﾁﾄﾞ	光学的マッチド	名詞
ｺｳｶﾞｸﾃｷﾓｰﾄﾞ	光学的モード	名詞
ｺｳｶﾞｸﾃｷｼﾝﾄﾞｳｼ	光学的振動子	名詞
ｺｳｶﾞｸﾂｳﾛ	光学通路	名詞
ｺｳｶﾞｸｼﾞｸ	光学軸	名詞
ｺｳｷﾞｻﾞﾋｮｳ	広義座標	名詞
ｺｳｺﾞｷﾝｾｲﾘﾂ	交互禁制律	名詞
ｺｳｺﾞｷｮｳｼﾞｭｳｺﾞｳﾀｲ	交互共重合体	名詞
ｺｳﾊｿｯｷｮ	光波測距	名詞
ｺｯﾎﾉﾌﾞﾝｻﾝｼｷ	コッホの分散式	名詞
ｺﾋｰﾚﾝｽ	コヒーレンス	名詞
ｺﾋｰﾚﾝｽｲﾝｼ	コヒーレンス因子	名詞
ｺﾋｰﾚﾝｽﾁｮｳ	コヒーレンス長	名詞
ｺﾋｰﾚﾝﾄ	コヒーレント	名詞
ｺﾋｰﾚﾝﾄﾋｮｳｼﾞ	コヒーレント表示	名詞
ｺﾋｰﾚﾝﾄｶﾄﾌﾞﾝｺｳﾎｳ	コヒーレント過渡分光法	名詞
ｺﾋｰﾚﾝﾄｺｳ	コヒーレント光	名詞
ｺﾋｰﾚﾝﾄﾎﾟﾃﾝｼｬﾙ	コヒーレントポテンシャル	名詞
ｺﾋｰﾚﾝﾄｻﾝﾗﾝ	コヒーレント散乱	名詞
ｺﾋｰﾚﾝﾄｾｲﾄﾞｳﾎｳｼｬ	コヒーレント制動放射	名詞
ｺﾋｰﾚﾝﾄｾｲｾｲ	コヒーレント生成	名詞
ｺﾋｰﾚﾝﾄｼﾞｮｳﾀｲ	コヒーレント状態	名詞
ｺｳﾎｳｻﾝﾗﾝ	後方散乱	名詞
ｺｳﾌｸﾃﾞﾝｱﾂ	降伏電圧	名詞
ｺｳﾌｸｵｳﾘｮｸ	降伏応力	名詞
ｺｳﾌｸﾃﾝ	降伏点	名詞
ｺｳﾌｸｼﾞｮｳｹﾝ	降伏条件	名詞
ｺｳｲｷｺﾝｾｲｷｮｳﾒｲ	高域混成共鳴	名詞
ｺｲﾝｼﾃﾞﾝｽ	コインシデンス	名詞
ｺｲﾝｼﾃﾞﾝｽｺｳｶ	コインシデンス効果	名詞
ｺｲﾝｼﾃﾞﾝｽﾘｭｳｶｲ	コインシデンス粒界	名詞
ｺｳｶｲﾍﾝ	光壊変	名詞
ｺｳｶﾝﾌﾞﾝｷｮｸ	交換分極	名詞
ｺｳｶﾝﾌﾞﾝﾚﾂ	交換分裂	名詞
ｺｳｶﾝﾃﾞﾝｶ	交換電荷	名詞
ｺｳｶﾝﾃﾞﾝﾘｭｳ	交換電流	名詞
ｺｳｶﾝﾊﾝﾉｳ	交換反応	名詞
ｺｳｶﾝﾊﾝﾃﾝ	交換反転	名詞
ｺｳｶﾝﾌｱﾝﾃｲｾｲ	交換不安定性	名詞
ｺｳｶﾝｶﾝｹｲ	交換関係	名詞
ｺｳｶﾝｶﾚﾝﾄ	交換カレント	名詞
ｺｳｶﾝｹｲｽｳ	交換係数	名詞
ｺｳｶﾝｺｳﾄﾞﾃｲｽｳ	交換硬度定数	名詞
ｺｳｶﾝﾎﾟﾃﾝｼｬﾙ	交換ポテンシャル	名詞
ｺｳｶﾝﾘｮｸ	交換力	名詞
ｺｳｶﾝｾｷﾌﾞﾝ	交換積分	名詞
ｺｳｶﾝｾﾝｴｲｶ	交換尖鋭化	名詞
ｺｳｶﾝｾﾝｴｲｶ	交換せん鋭化	名詞
ｺｳｶﾝｼ	交換子	名詞
ｺｳｶﾝｼｭｸﾀｲ	交換縮退	名詞
ｺｳｹｲﾋ	口径比	名詞
ｺｳｹｲｼｮｸ	口径食	名詞
ｺｳｷｱﾂｱｰｸ	高気圧アーク	名詞
ｺｯｸｸﾛﾌﾄﾜﾙﾄﾝ	コッククロフト・ワルトン	人名
ｺｳﾃﾞﾝｱﾂﾊｯｾｲｿｳﾁ	高電圧発生装置	名詞
ｺｳｺｳｻ	光行差	名詞
ｺｳｸｳﾘｷｶﾞｸ	航空力学	名詞
ｺｸｻｲｹﾞﾝｼｼﾞ	国際原子時	名詞
ｺｸｻｲﾋｮｳｼﾞｭﾝｶｷｺｳ	国際標準化機構	名詞
ｺｸｻｲｷﾛｸﾞﾗﾑｹﾞﾝｷ	国際キログラム原器	名詞
ｺｸｻｲｷｾｲﾌﾞｯｼﾂ	国際規制物質	名詞
ｺｸｻｲﾀﾝｲｹｲ	国際単位系	名詞
ｺｸｻｲｼﾞﾂﾖｳｵﾝﾄﾞﾒﾓﾘ	国際実用温度目盛	名詞
ｺｸﾀｲ	黒体	名詞
ｺｳｷｭｳ	光球	名詞
ｺｸﾀｲﾎｳｼｬ	黒体放射	名詞
ｺｸﾀｲﾌｸｼｬ	黒体輻射	名詞
ｺｷｭｳｷｭｳ	呼吸球	名詞
ｺﾏｼｭｳｻ	コマ収差	名詞
ｺｳﾐﾂﾄﾞｺﾝﾄﾞｳｺｳｶ	高密度近藤効果	名詞
ｺｳﾐﾂﾄﾞﾚｲｷｼ	高密度励起子	名詞
ｺｰﾅｰｷｭｰﾌﾞ	コーナーキューブ	名詞
ｺﾝﾀﾞｸﾀﾝｽ	コンダクタンス	名詞
ｺﾝﾄﾞｳｺｳｶ	近藤効果	名詞
ｺﾝﾄﾞｳｺｳｼ	近藤格子	名詞
ｺﾝﾄﾞﾝﾎｳﾌﾞﾂｾﾝ	コンドン放物線	名詞
ｺﾝﾄﾞｳｵﾝﾄﾞ	近藤温度	名詞
ｺﾝｺﾞｳﾊﾞ	混合場	名詞
ｺﾝｺﾞｳｹﾞﾝｼｶ	混合原子価	名詞
ｺﾝｺﾞｳﾎｳｼｬｾﾝﾊﾞ	混合放射線場	名詞
ｺﾝｺﾞｳｷｮﾘ	混合距離	名詞
ｺﾝｺﾞｳﾈﾂ	混合熱	名詞
ｺﾝｺﾞｳﾃﾝｲ	混合転位	名詞
ｺﾝｺﾞｳｼﾞｮｳﾀｲ	混合状態	名詞
ｺｰﾝｲｼﾞｮｳ	コーン異常	名詞
ｺｰﾝﾉﾃｲﾘ	コーンの定理	名詞
ｺﾉｽｺｰﾌﾟ	コノスコープ	名詞
ｺﾝﾊﾟｸﾄｸﾞﾝ	コンパクト群	名詞
ｺﾝﾊﾟｸﾄﾄｰﾗｽ	コンパクトトーラス	名詞
ｺﾝﾊﾟﾚｰﾀｰ	コンパレーター	名詞
ｺﾝﾌﾟﾗｲｱﾝｽ	コンプライアンス	名詞
ｺﾝﾌﾟﾄﾝ	コンプトン	人名
ｺﾝﾌﾟﾄﾝ	Compton	人名
ｺﾝﾌﾟﾄﾝｹﾞﾃｨﾝｸﾞｺｳｶ	コンプトン・ゲティング効果	名詞
ｺﾝﾌﾟﾄﾝﾊﾁｮｳ	コンプトン波長	名詞
ｺﾝﾌﾟﾄﾝｺｳｶ	コンプトン効果	名詞
ｺﾝﾌﾟﾄﾝﾗﾏﾝｻﾝﾗﾝ	コンプトン・ラマン散乱	名詞
ｺﾝﾌﾟﾄﾝｻﾝﾗﾝ	コンプトン散乱	名詞
ｼｮｳｹﾞﾝﾃﾞﾝｲｹｲ	象限電位計	名詞
ｺﾝｾｲｷﾄﾞｳ	混成軌道	名詞
ｺﾝｾｲｷﾄﾞｳｶﾝｽｳ	混成軌道関数	名詞
ｺﾝｾｲｼｭｾｷｶｲﾛ	混成集積回路	名詞
ｺﾝｿｳﾘｭｳ	混相流	名詞
ｺﾝｽﾋﾟﾗｼｰ	コンスピラシー	名詞
ｺｰﾝｼｬﾑﾉﾎｳﾎｳ	コーン・シャムの方法	名詞
ｺﾝｼｮｳ	混晶	名詞
ｺﾝｳｪﾙﾜｲｽｺｯﾌﾟﾉｼｷ	コンウェル・ワイスコップの式	名詞
ｺｳｵﾝｹｲ	高温計	名詞
ｺｳｵﾝｿｳ	恒温槽	名詞
ｺｳｵﾝﾃﾝｶｲ	高温展開	名詞
ｺｳｵﾝﾁｮｳﾃﾞﾝﾄﾞｳﾀｲ	高温超伝導体	名詞
ｺｳｵﾝｾﾞｲｶ	高温脆化	名詞
ｺﾍﾟﾝﾊｰｹﾞﾝｶｲｼｬｸ	コペンハーゲン解釈	名詞
ｺﾗﾑｷﾝｼﾞ	コラム近似	名詞
ｺｳﾚｲｷｹﾞﾝｼ	高励起原子	名詞
ｺﾚｸﾀｰｿﾝ	コレクター損	名詞
ｺﾚｽﾃﾘｯｸｿｳ	コレステリック相	名詞
ｺﾘﾒｰﾀｰ	コリメーター	名詞
ｺｵﾘﾈﾂﾘｮｳｹｲ	氷熱量計	名詞
ｺﾘﾝﾊﾉｶﾝｹｲｼｷ	コリンハの関係式	名詞
ｺﾘﾝﾊﾉｷｺｳ	コリンハの機構	名詞
ｺﾘｵﾘﾘｮｸ	コリオリ力	名詞
ｺﾘｵﾘﾉﾁｶﾗ	コリオリの力	名詞
ｺｳﾘﾛﾝﾃｷﾊﾞﾉﾘﾛﾝ	公理論的場の理論	名詞
ｺﾘﾂﾃﾞﾝｼﾂｲ	孤立電子対	名詞
ｺﾘﾂﾊ	孤立波	名詞
ｺﾘﾂｹｲ	孤立系	名詞
ｺｳﾛ	光路	名詞
ｺﾛｶﾞﾘﾏｻﾂ	転がり摩擦	名詞
ｺﾛﾅｸﾞﾗﾌ	コロナグラフ	名詞
ｺﾛﾅﾍｲｺｳ	コロナ平衡	名詞
ｺﾛﾅﾎｳﾃﾞﾝ	コロナ放電	名詞
ｺﾛﾅﾀｲﾃﾞﾝ	コロナ帯電	名詞
ｺｳﾛｻ	光路差	名詞
ｺｳﾛﾁｮｳ	光路長	名詞
ｺﾙﾋﾞｰﾉｴﾝﾊﾞﾝ	コルビーノ円板	名詞
ｺｰﾙﾄﾞﾄﾗｯﾌﾟ	コールドトラップ	名詞
ｺｰﾙｺｰﾙﾉｴﾝｺｿｸ	コール・コールの円弧則	名詞
ｺｰﾙﾏﾝﾉﾃｲﾘ	コールマンの定理	名詞
ｺﾙﾓｺﾞﾛﾌｽﾍﾟｸﾄﾙ	コルモゴロフスペクトル	名詞
ｺﾙﾆｭﾉｳｽﾞﾏｷ	コルニュの渦巻	名詞
ｺﾙﾋﾟｯﾂﾊｯｼﾝｷ	コルピッツ発振器	名詞
ｺｰﾙﾗｳｼｭﾌﾞﾘｯｼﾞ	コールラウシュブリッジ	名詞
ｺﾙﾄﾍﾞｰｸﾄﾞﾌﾘｰｽ	コルトベーク・ドフリース	人名
ｺｳﾘｮｳｼ	光量子	名詞
ｺｳﾘｮｳｿｸﾃｲ	光量測定	名詞
ｺｳﾘｭｳ	後流	名詞
ｺｳﾘｭｳﾊﾞｲｱｽ	交流バイアス	名詞
ｺｳﾘｭｳﾌﾞﾘｯｼﾞ	交流ブリッジ	名詞
ｺｳﾘｭｳﾃﾞﾝｱﾂ	交流電圧	名詞
ｺｳﾘｭｳﾃﾞﾝﾄﾞｳｷ	交流電動機	名詞
ｺｳﾘｭｳﾃﾞﾝｲｻｹｲ	交流電位差計	名詞
ｺｳﾘｭﾃﾞﾝﾘｮｸ	交流電力	名詞
ｺｳﾘｭｳﾃﾞﾝﾘｭｳｹｲ	交流電流計	名詞
ｺｳﾘｭｳﾊﾂﾃﾞﾝｷ	交流発電機	名詞
ｺｳﾘｭｳｶｲﾛ	交流回路	名詞
ｺｳﾘｭｳｷﾃﾞﾝﾘｮｸ	交流起電力	名詞
ｺｳﾘｭｳｺﾛﾅ	交流コロナ	名詞
ｺｳﾘｭｳﾓｰﾀｰ	交流モーター	名詞
ｺｳﾘｭｳｿﾞｳﾌｸｷ	交流増幅器	名詞
ｺｳﾘｭｳｼﾞｮｾﾌｿﾝｺｳｶ	交流ジョセフソン効果	名詞
ｺｳｻﾋﾞｰﾑﾎｳ	交差ビーム法	名詞
ｺｳｻｶｲﾋ	交差回避	名詞
ｺｳｻｶﾝｹｲ	交差関係	名詞
ｺｳｻｶﾝﾜ	交差緩和	名詞
ｺｳｻｽﾍﾞﾘ	交差すべり	名詞
ｺｳｻﾀｲｼｮｳｾｲ	交差対称性	名詞
ｺｳｾｲ	較正	名詞
ｺｳｾｲﾌﾞﾝ	硬成分	名詞
ｺｳｾｲｷｮｸｾﾝ	校正曲線	名詞
ｺｳｾｲﾈﾝ	恒星年	名詞
ｺｳｾｲｼｻ	恒星視差	名詞
ｺｳｾｲﾃｷﾊﾞﾉﾘﾛﾝ	構成的場の理論	名詞
ｺｳｾｲｼﾞ	恒星時	名詞
ｺｳｾｲｼﾞｮｳﾃﾞﾝﾊﾟｹﾞﾝ	恒星状電波源	名詞
ｺｳｾｲｼﾞｮｳﾃﾝﾀｲ	恒星状天体	名詞
ｺｳｾｷｹﾝﾊﾟｷ	鉱石検波器	名詞
ｺｳｾﾝｿｸ	光線束	名詞
ｺｳｾﾝｿｸﾄﾞ	光線速度	名詞
ｺｳｾﾝｿｸﾄﾞﾒﾝ	光線速度面	名詞
ｺｳｾﾝﾂｲｾｷ	光線追跡	名詞
ｺｳｼﾊﾞﾉﾘﾛﾝ	格子場の理論	名詞
ｺｳｼｴﾈﾙｷﾞｰ	格子エネルギー	名詞
ｺｳｼｹﾞｰｼﾞﾘﾛﾝ	格子ゲージ理論	名詞
ｺｳｼｸﾞﾘｰﾝｶﾝｽｳ	格子グリーン関数	名詞
ｺｳｼﾋﾈﾂ	格子比熱	名詞
ｺｰｼｰ	コーシー	人名
ｺｰｼｰ	Cauchy	人名
ｺｰｼｰﾓﾝﾀﾞｲ	コーシー問題	名詞
ｺｰｼｰﾘｰﾏﾝﾉｶﾝｹｲｼｷ	コーシー・リーマンの関係式	名詞
ｺｰｼｰｽｳ	コーシー数	名詞
ｺｳｼｶﾝｹﾞﾝｼ	格子間原子	名詞
ｺｳｼｶﾝｶｸ	格子間隔	名詞
ｺｳｼｶﾝｹｲ	格子関係	名詞
ｺｳｼｶﾝﾜ	格子緩和	名詞
ｺｳｼｹｲｽｳﾎｳ	光子計数法	名詞
ｺｳｼｹｯｶﾝ	格子欠陥	名詞
ｺｳｼｷﾀｲﾓｹｲ	格子気体模型	名詞
ｺｳｼﾒﾝ	格子面	名詞
ｺｳｼﾓｹｲ	格子模型	名詞
ｺｳｼﾝ	光心	名詞
ｺｳｼﾝﾊｶﾝ	後進波管	名詞
ｺｳｼﾝｶｿｸﾄﾞ	向心加速度	名詞
ｺｳｼﾝｸｳ	高真空	名詞
ｺｳｼﾝﾘｮｸ	向心力	名詞
ｺｳｼﾘｷｶﾞｸ	格子力学	名詞
ｺｳｼﾘﾛﾝ	格子理論	名詞
ｺｳｼｼﾝﾄﾞｳ	格子振動	名詞
ｺｳｼﾃｲｽｳ	格子定数	名詞
ｺｳｼﾄｳｹｲ	光子統計	名詞
ｺｳｼﾃﾝ	格子点	名詞
ｺｳｼｿﾞｳ	格子像	名詞
ｺｿｳ	固相	名詞
ｺｳｿｷｼﾂﾌｸｺﾞｳﾀｲ	酵素-基質複合体	名詞
ｺｳｿｸ	光束	名詞
ｺｳｿｸ	光速	名詞
ｺｳｿｸﾄﾞ	光速度	名詞
ｺｳｿｸﾄﾞｼﾝｸｳｹｲ	高速度真空計	名詞
ｺｳｿｸﾌｰﾘｴﾍﾝｶﾝ	高速フーリエ変換	名詞
ｺｳｿｸｲｵﾝｸﾗｽﾀｰ	高速イオンクラスター	名詞
ｺｳｿｸｶｸﾌﾞﾝﾚﾂ	高速核分裂	名詞
ｺｳｿｸｶｸｻﾝ	高速拡散	名詞
ｺｳｿｸｷﾘｭｳ	高速気流	名詞
ｺｳｿｸﾛ	高速炉	名詞
ｺｳｿｸｿｳｲﾝﾌﾞﾝｺｳﾎｳ	高速掃引分光法	名詞
ｺｳｿｸﾁｭｳｾｲｼ	高速中性子	名詞
ｺｳｿｸﾁｭｳｾｲｼﾛ	高速中性子炉	名詞
ｺｳｿｸｳﾝﾄﾞｳ	拘束運動	名詞
ｺｳｿｸｿﾞｳｼｮｸﾛ	高速増殖炉	名詞
ｺｿｳｾｲﾁｮｳ	固相成長	名詞
ｺｿｳｾﾝ	固相線	名詞
ｺｯｾﾙﾒｰﾚﾝｼｭﾃｯﾄｿﾞｳ	コッセル・メーレンシュテット像	名詞
ｺｯｾﾙｾﾝ	コッセル線	名詞
ｺｽｳｴﾝｻﾞﾝｼ	個数演算子	名詞
ｺｳｽﾋﾟﾝｼﾞｮｳﾀｲ	高スピン状態	名詞
ｺｽﾀｰｸﾛｰﾆｯﾋｾﾝｲ	コスター・クローニッヒ遷移	名詞
ｺｽﾀﾘｯﾂｻｳﾚｽﾃﾝｲ	コスタリッツ・サウレス転移	名詞
ｺｳｼｮｳｵｳﾘｮｸ	公称応力	名詞
ｺｰｼｭｱｶﾞﾀｹｯｼｮｳﾎｳ	コーシュア型結晶法	名詞
ｺｳｼｭｳﾊｶﾞﾀ	高周波型	名詞
ﾘｭｳｼﾌﾞﾝﾘｿｳﾁ	粒子分離装置	名詞
ｺｳｼｭｳﾊﾎｶｸ	高周波捕獲	名詞
ｺｳｼｭｳﾊｶﾈﾂ	高周波加熱	名詞
ｺｳｼｭｳﾊｶｿｸ	高周波加速	名詞
ｺｳｼｭｳﾊﾀﾝｼﾝ	高周波探針	名詞
ｺｳｼｭﾊﾄｼﾞｺﾒ	高周波閉込め	名詞
ｺﾀｲﾌﾞﾂﾘｶﾞｸ	固体物理学	名詞
ｺﾀｲﾃﾞﾝﾊﾟﾝｵﾝ	固体伝搬音	名詞
ｺﾀｲｴﾚｸﾄﾛﾆｸｽ	固体エレクトロニクス	名詞
ｺｳﾀｲｲｷｿﾞｳﾌｸｷ	広帯域増幅器	名詞
ｺﾀｲｶｲﾛ	固体回路	名詞
ｺﾀｲｹﾝｼｭﾂｷ	固体検出器	名詞
ｺﾀｲﾅｲｶｸｻﾝ	固体内拡散	名詞
ｺﾀｲﾋﾟﾝﾁ	固体ピンチ	名詞
ｺﾀｲﾌﾟﾗｽﾞﾏ	固体プラズマ	名詞
ｺﾀｲﾚｰｻﾞｰ	固体レーザー	名詞
ｺﾃｲｷｮｸ	固定極	名詞
ｺﾃｲｼｮｳｽｳﾃﾝﾋｮｳｼﾞ	固定小数点表示	名詞
ｺﾃｲﾀﾝ	固定端	名詞
ｺﾃｲﾃｲｺｳｷ	固定抵抗器	名詞
ｺﾃｲﾃﾝ	固定点	名詞
ｺｳﾃｷﾘｮｳｼｶ	光的量子化	名詞
ｺﾃﾝﾌﾞﾂﾘｶﾞｸ	古典物理学	名詞
ｺﾃﾝﾃﾞﾝｼﾊﾝｹｲ	古典電子半径	名詞
ｺﾃﾝﾃﾞﾝｼﾛﾝ	古典電子論	名詞
ｺﾃﾝｸﾞﾝ	古典群	名詞
ｺﾃﾝｶｸｻﾝｹｲｽｳ	古典拡散係数	名詞
ｺﾃﾝｷｭｳｼｭｳ	古典吸収	名詞
ｺﾃﾝﾘｷｶﾞｸ	古典力学	名詞
ｺﾃﾝﾘｮｳｼﾛﾝ	古典量子論	名詞
ｺﾃﾝﾄｳｹｲﾘｷｶﾞｸ	古典統計力学	名詞
ｺｳﾁ	項値	名詞
ｺﾄｳｼｷ	恒等式	名詞
ｺｳﾄｳｼﾞﾘﾂｻﾞｲﾘｮｳ	高透磁率材料	名詞
ｺｯﾄﾝｺｳｶ	コットン効果	名詞
ｺｯﾄﾝﾑｰﾄﾝｺｳｶ	コットン・ムートン効果	名詞
ｺｯﾄﾚﾙﾌﾝｲｷ	コットレル雰囲気	名詞
ｺｯﾄﾚﾙﾛｰﾏｰ	コットレル・ローマー	人名
ﾌﾄﾞｳﾃﾝｲ	不動転位	名詞
ｺｳﾁｬｸｴﾝﾊﾞﾝ	降着円盤	名詞
ｺｳﾁｮｳ	こう長	名詞
ｺｳﾁｮｳﾃﾞﾝﾄﾞｳﾀｲ	硬超伝導体	名詞
ｺｳﾁｮｳﾊ	高調波	名詞
ｺｳﾁｮｳﾄﾞ	高調度	名詞
ｺｳXｾﾝ	硬X線	名詞
ｺﾖｳｹﾞﾝｶｲ	固溶限界	名詞
ｺﾖｳﾀｲ	固溶体	名詞
ｺﾖｳﾀｲｺｳｶ	固溶体硬化	名詞
ｺﾕｳﾊﾝﾄﾞｳﾀｲ	固有半導体	名詞
ｺﾕｳﾍﾝｺｳ	固有偏光	名詞
ｺﾕｳｶﾝｽｳ	固有関数	名詞
ｺﾕｳｶﾝｽｳﾃﾝｶｲ	固有関数展開	名詞
ｺﾕｳﾈﾝﾄﾞ	固有粘度	名詞
ｺﾕｳﾈﾝｾｲ	固有粘性	名詞
ｺﾕｳｵﾝｷｮｳﾃｲｺｳ	固有音響抵抗	名詞
ｺﾕｳﾎﾟｱﾝｶﾚｸﾞﾝ	固有ポアンカレ群	名詞
ｺﾕｳﾛｰﾚﾝﾂｸﾞﾝ	固有ローレンツ群	名詞
ｺﾕｳﾛｰﾚﾝﾂﾍﾝｶﾝ	固有ローレンツ変換	名詞
ｺﾕｳｼﾝﾄﾞｳ	固有振動	名詞
ｺﾕｳｼﾝﾄﾞｳｽｳ	固有振動数	名詞
ｺﾕｳｼﾂﾘｮｳ	固有質量	名詞
ｺﾕｳﾁ	固有値	名詞
ｺﾕｳｳﾝﾄﾞｳ	固有運動	名詞
ｺﾕｳﾜ	固有和	名詞
ｺﾕｳXｾﾝ	固有X線	名詞
ｺﾕｳｻﾞﾋｮｳｹｲ	固有座標系	名詞
ｺﾕｳｼﾞ	固有時	名詞
ｺｳｼﾞﾊﾞ	高磁場	名詞
ｺｳｼﾞﾌﾞﾝｷｮｸﾘﾂ	高次分極率	名詞
ｺｳｼﾞｺｳｶ	高次効果	名詞
ｺｳｼﾞｺｳｿﾞｳ	高次構造	名詞
ｺｳｼﾞｸ	光軸	名詞
ｺｳｼﾞｸﾌﾞﾝｻﾝ	光軸分散	名詞
ｺｼﾞﾝｺﾞｻ	個人誤差	名詞
ｺｼﾞﾝｾﾝﾘｮｳｿｸﾃｲ	個人線量測定	名詞
ｺｳｼﾞﾘｮｸ	抗磁力	名詞
ｺｳｼﾞｾｲｻﾞｲﾘｮｳ	硬磁性材料	名詞
ｺｳｼﾞｾﾝｲ	高次遷移	名詞
ｺｳｿﾞｳﾎｳ	光像法	名詞
ｺｳｿﾞｳﾌﾍﾝﾘｮｳ	構造不変量	名詞
ｺｳｿﾞｳｲﾝｼ	構造因子	名詞
ｺｳｿﾞｳｶｲｾｷ	構造解析	名詞
ｺｳｿﾞｳｶﾝｽｳ	構造関数	名詞
ｺｳｿﾞｳｶﾝﾜ	構造緩和	名詞
ｺｳｿﾞｳｿｳﾃﾝｲ	構造相転移	名詞
ｺｳｿﾞｳﾃｲｽｳ	構造定数	名詞
ｺｳｿﾞｳｿﾞｳ	構造像	名詞
ｺｳｼﾞｭｳｺﾞｳﾀｲ	高重合体	名詞
ｸﾎﾞｺｳｼｷ	久保公式	名詞
ｸｳﾎﾞｳｿｳ	空乏層	名詞
ｸｳﾃﾞﾝ	空電	名詞
ｸｰﾃﾞｼｮｳﾃﾝ	クーデ焦点	名詞
ｸｳﾄﾞｳｹﾞﾝｼｮｳ	空洞現象	名詞
ｸｳﾄﾞｳﾊﾁｮｳｹｲ	空洞波長計	名詞
ｸｳﾄﾞｳﾎｳｼｬ	空洞放射	名詞
ｸｳﾄﾞｳｷｮｳｼﾝｷ	空洞共振器	名詞
ｸﾄﾞｳﾘｮｸ	駆動力	名詞
ｸｳﾄﾞｳﾃﾝｲ	空洞転位	名詞
ｸｴﾝﾁ	クエンチ	名詞
ｸｴｯﾄﾉﾅｶﾞﾚ	クエットの流れ	名詞
ｸｳｹﾞｷ	空げき	名詞
ｸｳｹﾞｷﾘﾂ	空げき率	名詞
ｸｳｶﾝﾌﾞﾝｶｲｽﾍﾟｸﾄﾙ	空間分解スペクトル	名詞
ｸｳｶﾝﾃﾞﾝｲ	空間電位	名詞
ｸｳｶﾝﾃﾞﾝｶ	空間電荷	名詞
ｸｳｶﾝﾃﾞﾝｶｺｳｶ	空間電荷効果	名詞
ｸｳｶﾝﾃﾞﾝｶｺｳｼ	空間電荷格子	名詞
ｸｳｶﾝﾃﾞﾝｶｾｲｹﾞﾝ	空間電荷制限	名詞
ｸｳｶﾝﾃﾞﾝｶｿｳ	空間電荷層	名詞
ｸｳｶﾝｸﾞﾝ	空間群	名詞
ｸｳｶﾝﾊﾝﾃﾝ	空間反転	名詞
ｸｳｶﾝｲｿﾞﾝｾｲ	空間依存性	名詞
ｸｳｶﾝｺﾋｰﾚﾝｽ	空間コヒーレンス	名詞
ｸｳｶﾝｺｳｼ	空間格子	名詞
ｸｳｶﾝｺﾃｲｻﾞﾋｮｳｹｲ	空間固定座標系	名詞
ｸｳｶﾝﾘﾂ	空間率	名詞
ｸｳｶﾝｼｭｳﾊｽｳ	空間周波数	名詞
ﾌｨﾙﾀﾘﾝｸﾞ	フィルタリング	名詞
ｽﾍﾟｸﾄﾙ	スペクトル	名詞
ｸｳｶﾝｺﾋｰﾚﾝﾝｽ	空間コヒーレンス	名詞
ｸｳｶﾝﾃｷｺﾋｰﾚﾝｽ	空間的コヒーレンス	名詞
ｸｹｲﾊ	くけい波	名詞
ｸｳｷﾃﾞﾝﾊﾟﾝｵﾝ	空気伝搬音	名詞
ｸｳｷﾃﾞﾝﾁ	空気電池	名詞
ｸｳｷｺﾝﾃﾞﾝｻｰ	空気コンデンサー	名詞
ｸｳｷﾏｲｸﾛﾒｰﾀｰ	空気マイクロメーター	名詞
ｸｳｷﾓﾆﾀｰ	空気モニター	名詞
ｸｳｷﾘｷｶﾞｸ	空気力学	名詞
ｸｳｷｼｬﾜｰ	空気シャワー	名詞
ｸｯｷｮｸｾｲｺｳﾌﾞﾝｼ	屈曲性高分子	名詞
ｸｳｺｳ	空孔	名詞
ｸｳｺｳｶｸｻﾝ	空孔拡散	名詞
ｸｳｺｳｸｳｺｳｿｳｺﾞｻﾖｳ	空孔-空孔相互作用	名詞
ｸｳｺｳﾘﾛﾝ	空孔理論	名詞
ｸｳｺｳｼﾃﾝ	空格子点	名詞
ｸﾐｱﾜｾｶﾝｹｲ	組合せ関係	名詞
ｸﾐｱﾜｾｹｯｿﾝ	組合せ欠損	名詞
ｸﾐｱﾜｾｵｳﾘｮｸ	組合せ応力	名詞
ｸﾐｱﾜｾｻ	組合せ差	名詞
ｸﾐｶｴｻﾝﾗﾝ	組換え散乱	名詞
ｸﾐﾀﾃﾉｹﾞﾝﾘ	組立の原理	名詞
ｸﾐﾀﾃﾀﾝｲ	組立単位	名詞
ｸﾐﾀﾃｽｳ	組立数	名詞
ｸﾓﾘｽｲｼｮｳｷｭｳﾓｹｲ	曇り水晶球模型	名詞
ｸﾈｰﾙﾎｳ	クネール法	名詞
ｸﾝﾄﾉｼﾞｯｹﾝ	クントの実験	名詞
ｸﾇｰｾﾝ	クヌーセン	人名
ｸﾇｰｾﾝ	Knudsen	人名
ｸﾇｰｾﾝｹﾞｰｼﾞ	クヌーセンゲージ	名詞
ｸﾇｰｾﾝﾘｮｳｲｷ	クヌーセン領域	名詞
ｸﾇｰｾﾝﾘｭｳ	クヌーセン流	名詞
ｸｰﾊﾟｰｷｮｸｼｮｳ	クーパー極小	名詞
ｸｰﾊﾟｰﾂｲ	クーパー対	名詞
ｸｰﾌﾟﾏﾝｽﾃｲﾘ	クープマンス定理	名詞
ｸﾗｯﾄﾞ	クラッド	名詞
ｸﾗﾄﾞﾆｽﾞｹｲ	クラドニ図形	名詞
ｸﾗｲﾝ	クライン	人名
ｸﾗｲﾝ	Klein	人名
ｸﾗｲﾝｺﾞﾙﾄﾞﾝﾎｳﾃｲｼｷ	クライン・ゴルドン方程式	名詞
ｸﾗｲﾝﾆｼﾅﾉｺｳｼｷ	クライン・仁科の公式	名詞
ｸﾗｲﾝﾉﾊﾟﾗﾄﾞｯｸｽ	クラインのパラドックス	名詞
ｸﾗｲｵ	クライオ	名詞
ｸﾗｲｵｴﾚｸﾄﾛﾆｸｽ	クライオエレクトロニクス	名詞
ｺﾝﾃﾞﾝｾｰｼｮﾝﾎﾟﾝﾌﾟ	コンデンセーションポンプ	名詞
ｸﾗｲｵﾊﾟﾈﾙ	クライオパネル	名詞
ｸﾗｲｵﾎﾟﾝﾌﾟ	クライオポンプ	名詞
ｸﾗｲｵｻｰ	クライオサー	名詞
ｸﾗｲｵｿｰﾌﾟｼｮﾝﾎﾟﾝﾌﾟ	クライオソープションポンプ	名詞
ｸﾗｲｵｽﾀｯﾄ	クライオスタット	名詞
ｸﾗｲｵﾄﾗｯﾋﾟﾝｸﾞ	クライオトラッピング	名詞
ｸﾗｲｵﾄﾛﾝ	クライオトロン	名詞
ｸﾗｲｵｾﾞﾆｯｸﾎﾟﾝﾌﾟ	クライオゼニックポンプ	名詞
ｸﾗｲｽﾄﾛﾝ	クライストロン	名詞
ｸﾗｯｷﾝｸﾞﾊﾟﾀｰﾝ	クラッキングパターン	名詞
ｸﾗｰｸｽｳ	クラーク数	名詞
ｸﾗﾏｰｽ	クラマース	人名
ｸﾗﾏｰｽ	Kramers	人名
ｸﾗﾏｰｽﾊｲｾﾞﾝﾍﾞﾙｸﾞ	クラマース・ハイゼンベルグ	人名
ｸﾗﾏｰｽｸﾛｰﾆｯﾋ	クラマース・クローニッヒ	人名
ｸﾗﾏｰｽﾉﾆｼﾞｭｳｺｳ	クラマースの二重項	名詞
ｸﾗﾏｰｽﾉﾃｲﾘ	クラマースの定理	名詞
ｸﾗﾝｷﾝｸﾞﾓｹｲ	クランキング模型	名詞
ｸﾗﾝﾌﾟ	クランプ	名詞
ｸﾗｽﾀｰ	クラスター	名詞
ｸﾗｽﾀｰﾓｹｲ	クラスター模型	名詞
ｸﾗｽﾀｰｾｲ	クラスター性	名詞
ｸﾗｽﾀｰｾｷﾌﾞﾝ	クラスター積分	名詞
ｸﾗｽﾀｰﾃﾝｶｲ	クラスター展開	名詞
ｸﾗﾂｷｰｶﾒﾗ	クラツキーカメラ	名詞
ｸﾗｳﾃﾞｨｵﾝ	クラウディオン	名詞
ｸﾗｳｼﾞﾝｸﾞｹｲｽｳ	クラウジング係数	名詞
ｸﾗｳｼﾞｳｽ	クラウジウス	人名
ｸﾗｳｼﾞｳｽ	Clausius	人名
ｸﾗｳｼﾞｳｽｸﾗﾍﾟｲﾛﾝ	クラジウス・クラペイロン	人名
ｸﾗｼﾞｳｽﾓｿｯﾃｨﾉｼｷ	クラジウス・モソッティの式	名詞
ｸﾗｼﾞｳｽﾉｹﾞﾝﾘ	クラジウスの原理	名詞
ｸﾗｼﾞｳｽﾉﾌﾄｳｼｷ	クラジウスの不等式	名詞
ｸﾚﾌﾞｼｭｺﾞﾙﾀﾞﾝｹｲｽｳ	クレブシュ・ゴルダン係数	名詞
ｸﾚｰｼﾞﾝｸﾞ	クレージング	名詞
ｸﾘｰﾌﾟ	クリープ	名詞
ｸﾘｶｴｼﾊﾝｼｬｶﾝｼｮｳ	繰返し反射干渉	名詞
ｸﾘｶｴｼｶﾝｼｮｳﾎｳ	繰返し干渉法	名詞
ｸﾘｶｴｼｵｳﾘｮｳｸ	繰返し応力	名詞
ｸﾘｺﾐ	くりこみ	名詞
ｸﾘｺﾐﾘﾛﾝ	くりこみ理論	名詞
ｸﾘｺﾐｸﾞﾝ	くりこみ群	名詞
ｸﾘﾉﾒｰﾀｰ	クリノメーター	名詞
ｸﾘﾌﾟﾄﾝｼﾝﾒﾄﾘｰ	クリプトンシンメトリー	名詞
ｸﾘｽﾀﾙﾌｨﾙﾀｰ	クリスタルフィルター	名詞
ｸﾘｽﾄｯﾌｪﾙﾉｷｺﾞｳ	クリストッフェルの記号	名詞
ｸｰﾘｯｼﾞｶﾝ	クーリッジ管	名詞
ｸﾛｰﾊﾟｰｽｲｯﾁ	クローパースイッチ	名詞
ｸﾛｰﾄﾞｻｲｸﾙ	クロードサイクル	名詞
ｸﾛｯｸﾊﾟﾙｽ	クロックパルス	名詞
ｸﾛﾏﾃｨｼﾃｨ	クロマティシティ	名詞
ｸﾛﾒﾙｱﾙﾒﾙﾈﾂﾃﾞﾝﾂｲ	クロメル-アルメル熱電対	名詞
ｸﾛﾒﾙﾄﾞｳﾈﾂﾃﾞﾝﾂｲ	クロメル-銅熱電対	名詞
ｸﾛﾒﾙｺﾝｽﾀﾝﾀﾝ	クロメル-コンスタンタン	名詞
ｸｰﾛﾝﾎﾞﾙﾝｷﾝｼﾞ	クーロン・ボルン近似	名詞
ｸﾛﾈｯｶｰﾉﾃﾞﾙﾀ	クロネッカーのδ	名詞
ｸｰﾛﾝｴﾈﾙｷﾞｰ	クーロンエネルギー	名詞
ｸｰﾛﾝｴﾈﾙｷﾞｰｻ	クーロンエネルギー差	名詞
ｸｰﾛﾝｹﾞｰｼﾞ	クローンゲージ	名詞
ｸｰﾛﾝｷﾞｬｯﾌﾟ	クーロンギャップ	名詞
ｸｰﾛﾝｷﾝｼﾞ	クーロン近似	名詞
ｸｰﾛﾝﾉﾎｳｿｸ	クーロンの法則	名詞
ｸﾛﾉﾄﾛﾝ	クロノトロン	名詞
ｸｰﾛﾝﾎﾟﾃﾝｼｬﾙ	クーロンポテンシャル	名詞
ｸｰﾛﾝﾚｲｷ	クーロン励起	名詞
ｸｰﾛﾝﾘｮｸ	クーロン力	名詞
ｸｰﾛﾝｻﾝﾗﾝ	クーロン散乱	名詞
ｸｰﾛﾝｾｷﾌﾞﾝ	クーロン積分	名詞
ｸｰﾛﾝｼｮｳﾍｷ	クーロン障壁	名詞
ｸｰﾛﾝｼｮｳﾄﾂ	クーロン衝突	名詞
ｸｰﾛﾝﾀｲｽｳ	クーロン対数	名詞
ｸﾛｯﾊﾟｰｹﾞｰｼﾞ	クロッパーゲージ	名詞
ｸﾛｰﾙﾙｰﾀﾞｰﾏﾝﾉﾃｲﾘ	クロール・ルーダーマンの定理	名詞
ｸﾛｼﾛｸﾞﾝ	黒白群	名詞
ｸﾛｽｵｰﾊﾞｰｺｳｶ	クロスオーバー効果	名詞
ｸﾛｰｼﾞﾔｰｷﾝｼﾞ	クロージャー近似	名詞
ｸﾙｯｸｽｱﾝﾌﾞ	クルックス暗部	名詞
ｸﾙｯｸｽｶﾝ	クルックス管	名詞
ｱﾝﾌﾞ	暗部	名詞
ｸﾙｽｶﾙﾉｼﾞｸｳ	クルスカルの時空	名詞
ｸﾙｽｶﾙｼｬﾌﾗﾉﾌｹﾞﾝｶｲ	クルスカル・シャフラノフ限界	名詞
ｸｳｼｹﾝ	空試験	名詞
ｸｯｾﾂｲｼﾞｮｳ	屈折異常	名詞
ｸｯｾﾂｶｸ	屈折角	名詞
ｸｯｾﾂｹｲ	屈折計	名詞
ｸｯｾﾂﾘﾂ	屈折率	名詞
ｸｯｾﾂﾘﾂﾀﾞｴﾝﾀｲ	屈折率だ円体	名詞
ｸｯｾﾂﾘﾂﾀﾞｴﾝﾀｲ	屈折率楕円体	名詞
ｸｯｾﾂﾘﾂﾒﾝ	屈折率面	名詞
ｸｯﾀﾉｼﾞｮｳｹﾝ	クッタの条件	名詞
ｸｳﾁｭｳｾﾝ	空中線	名詞
ｸｪｰｻｰ	クェーサー	名詞
ｸｴｰｻｰ	クェーサー	名詞
ｸｫｰｸ	クォーク	名詞
ｸｵｰｸ	クォーク	名詞
ｸｫｰｸｸﾞﾙｰｵﾝﾌﾟﾗｽﾞﾏ	クォークグルーオンプラズマ	名詞
ｸｫｰｸｸﾗｽﾀｰﾓｹｲ	クォーククラスター模型	名詞
ｸｫｰｸﾓｹｲ	クォーク模型	名詞
ｸｫｰｸﾊﾟｰﾄﾝﾓｹｲ	クォークパートン模型	名詞
ｸｫｰｸﾚﾌﾟﾄﾝﾀｲｼｮｳｾｲ	クォークレプトン対称性	名詞
ｷｬﾍﾞﾝﾃﾞｨｼｭﾉｼﾞｯｹﾝ	キャベンディシュの実験	名詞
ｷｬﾋﾞﾃﾞｰｼｮﾝ	キャビテーション	名詞
ｷｬﾋﾞﾃｨﾀﾞﾝﾋﾟﾝｸﾞ	キャビティダンピング	名詞
ｷｬﾊﾟｼﾀｰ	キャパシター	名詞
ｷｬﾘﾔｰ	キャリヤー	名詞
ｷｬﾘﾔｰﾌﾘｰ	キャリヤーフリー	名詞
ｷｬﾘﾔｰﾉﾎｼｮｳ	キャリヤーの補償	名詞
ｷｬﾘﾔｰﾁｭｳﾆｭｳ	キャリヤー注入	名詞
ｷｬﾘﾔｰｼﾞｭﾐｮｳ	キャリヤー寿命	名詞
ｷｬｯﾂｱｲ	キャッツアイ	名詞
ｷｮﾀﾞｲｸﾞﾛｰﾘｻﾝﾗﾝ	巨大グローリ散乱	名詞
ｷｮﾀﾞｲｷｮｳﾒｲ	巨大共鳴	名詞
ｷｮﾀﾞｲﾘｮｳｼｹﾞﾝｽｲ	巨大量子減衰	名詞
ｷｮﾀﾞｲｼﾞｷﾓｰﾒﾝﾄ	巨大磁気モーメント	名詞
ｷｮｳﾀﾞﾝｾｲ	強弾性	名詞
ｷｮｳﾀﾞﾝｾｲﾌﾞﾝｲｷ	強弾性分域	名詞
ｷｮｳﾀﾞﾝｾｲｿｳﾃﾝｲ	強弾性相転移	名詞
ｷｮｳﾄﾞｳｹﾞﾝｼｮｳ	協同現象	名詞
ｷｮｳﾄﾞﾍﾝﾁｮｳ	強度変調	名詞
ｷｮｳﾄﾞｲﾝｼ	強度因子	名詞
ｷｮｳﾄﾞｶﾝｽｳ	強度関数	名詞
ｷｮｳﾄﾞｶﾝｼｮｳｹｲ	強度干渉計	名詞
ｷｮｳﾄﾞｺｳﾀｲ	強度交代	名詞
ｷｮｳﾄﾞﾘｮｳｲｷ	強度領域	名詞
ｷｮｳｴｲ	鏡映	名詞
ｷｮｳｴｲﾃﾞﾝｶ	鏡映電荷	名詞
ｷｮｳｴｲｶｸ	鏡映核	名詞
ｷｮｳｴｲﾀｲｼｮｳ	鏡映対称	名詞
ｷｮｳﾍﾝ	共変	名詞
ｷｮｳﾍﾝﾍﾞｸﾄﾙ	共変ベクトル	名詞
ｷｮｳﾍﾝﾋﾞﾌﾞﾝ	共変微分	名詞
ｷｮｳﾍﾝｾｲ	共変性	名詞
ｷｮｳﾌﾂ	共沸	名詞
ｷｮｳｶｲｿｳ	境界層	名詞
ｷｮｳｶｲﾁﾓﾝﾀﾞｲ	境界値問題	名詞
ｷｮｳｶｲｼﾞｭﾝｶﾂ	境界潤滑	名詞
ｷｮｳｹｲﾍﾝｶﾝ	共形変換	名詞
ｷｮｳｹﾂｺﾞｳ	強結合	名詞
ｷｮｺｳｹﾞﾝ	虚光源	名詞
ｷｮｸﾀﾞｲｶﾝｿｸﾘｮｳ	極大観測量	名詞
ｷｮｸｹﾞﾝﾍｲｷﾄﾞｳ	極限閉軌道	名詞
ｷｮｸｹﾞﾝｶｲｾｷ	極限解析	名詞
ｷｮｸｹﾞﾝﾈﾝﾄﾞｽｳ	極限粘度数	名詞
ｷｮｸｹﾞﾝｾｯｹｲ	極限設計	名詞
ｷｮｸｶﾝｵﾝﾄﾞｹｲ	曲管温度計	名詞
ｷｮｸｺｳｼﾝｸｳ	極高真空	名詞
ｷｮｸﾘﾂ	曲率	名詞
ｷｮｸﾘﾂﾊﾝｹｲ	曲率半径	名詞
ｷｮｸﾘﾂﾃﾝｿﾙ	曲率テンソル	名詞
ｷｮｸﾘﾂﾁｭｳｼﾝ	曲率中心	名詞
ｷｮｸｾｲ	極性	名詞
ｷｮｸｾｲﾌﾞﾝｼ	極性分子	名詞
ｷｮｸｾｲｴｷﾀｲ	極性液体	名詞
ｷｮｸｾｲｹｯｼｮｳ	極性結晶	名詞
ｷｮｸｾｲｷﾀｲ	極性気体	名詞
ｷｮｸｾﾝﾉｱﾃﾊﾒ	曲線のあてはめ	名詞
ｷｮｸｼｶﾞｲｾﾝ	極紫外線	名詞
ｷｮｸｼｮﾊﾞ	局所場	名詞
ｷｮｸｼｮﾃﾞﾝﾊﾞ	局所電場	名詞
ｷｮｸｼｮｳﾊｿｸ	極小波束	名詞
ｷｮｸｼｮﾍｲｺｳ	局所平衡	名詞
ｷｮｸｼｮｶｶﾝｾｲ	局所可換性	名詞
ｷｮｸｼｮｶﾝｾｲｹｲ	局所慣性系	名詞
ｷｮｸｼｮｶﾝｾｲｻﾞﾋｮｳｹｲ	局所慣性座標系	名詞
ｷｮｸｼｮｳｷｮｸﾒﾝ	極小曲面	名詞
ｷｮｸｼｮﾏｯﾊｽｳ	局所マッハ数	名詞
ｷｮｸｼｮﾐﾂﾄﾞﾊﾝｶﾝｽｳ	局所密度汎関数	名詞
ｷｮｸｼｮｾｲｼｹｲ	局所静止系	名詞
ｷｮｸｼｮｿｳｺﾞｻﾖｳ	局所相互作用	名詞
ｽﾋﾟﾝﾐﾂﾄﾞﾊﾝｶﾝｽｳﾎｳ	スピン密度汎関数法	名詞
ｷｮｸｼｮﾃｷﾎｳｼｬｾﾝｺｳｶ	局所的放射線効果	名詞
ｷｮｸｼｮﾃｷﾈﾂﾍｲｺｳ	局所的熱平衡	名詞
ｷｮｸｼｮｼﾞｮｳﾀｲﾐﾂﾄﾞ	局所状態密度	名詞
ｷｮｸﾃｲｵﾝ	極低温	名詞
ｷｮｸﾃﾝﾄｳｴｲ	極点投影	名詞
ｷｮｸﾁ	極値	名詞
ｷｮｸﾁﾌﾞﾝﾌﾟ	極値分布	名詞
ｷｮｸﾁｮｳｵﾝﾊﾟ	極超音波	名詞
ｷｮｸﾁｮｳｵﾝｿｸ	極超音速	名詞
ｷｮｸﾁｮｳｵﾝｿｸ	極超音速	連体詞
ｷｮｸｻﾞﾋｮｳ	極座標	名詞
ｷｮｸｻﾞｲﾃﾞﾝｼ	局在電子	名詞
ｷｮｸｻﾞｲｷﾄﾞｳ	局在軌道	名詞
ｷｮｸｻﾞｲｷﾄﾞｳｶﾝｽｳ	局在軌道関数	名詞
ｷｮｸｻﾞｲﾓｰﾄﾞ	局在モード	名詞
ｷｮｸｻﾞｲｼﾅｲ	局在しない	名詞
ｷｮｸｻﾞｲｼﾝﾄﾞｳ	局在振動	名詞
ｷｮｸｻﾞｲｽﾋﾟﾝﾓｹｲ	局在スピン模型	名詞
ｷｮｸｻﾞｲｼﾞｷﾓｰﾒﾝﾄ	局在磁気モーメント	名詞
ｷｮｸｻﾞｲｼﾞｮｳﾀｲ	局在状態	名詞
ｷｮｸｻﾞｲｼﾞｭﾝｲ	局在準位	名詞
ｷｮｳﾒｲﾊﾞｺ	共鳴箱	名詞
ｷｮｳﾒｲﾋﾞｰﾑﾄﾘﾀﾞｼ	共鳴ビーム取出し	名詞
ｷｮｳﾒｲｴﾈﾙｷﾞｰ	共鳴エネルギー	名詞
ｷｮｳﾒｲﾎｶｸ	共鳴捕獲	名詞
ｷｮｳﾒｲﾎｳｼｬ	共鳴放射	名詞
ｷｮｳﾒｲｹｲｺｳ	共鳴蛍光	名詞
ｷｮｳﾒｲｷ	共鳴器	名詞
ｷｮｳﾒｲｺｳｼｷ	共鳴公式	名詞
ｷｮｳﾒｲｷｮｸｾﾝ	共鳴曲線	名詞
ｷｮｳﾒｲｷｭｳｼｭｳ	共鳴吸収	名詞
ｷｮｳﾒｲﾗﾏﾝｺｳｶ	共鳴ラマン効果	名詞
ｷｮｳﾒｲﾘｭｳｼ	共鳴粒子	名詞
ｷｮｳﾒｲｻﾝﾗﾝ	共鳴散乱	名詞
ｷｮｳﾒｲｾｷﾌﾞﾝ	共鳴積分	名詞
ｷｮｳﾒｲｾﾝ	共鳴線	名詞
ｷｮｳﾒｲｿｳｺﾞｻﾖｳ	共鳴相互作用	名詞
ｷｮｳﾒｲｽﾍﾟｸﾄﾙ	共鳴スペクトル	名詞
ｷｮｳﾒｲﾀﾝｼﾝ	共鳴探針	名詞
ｷｮｳﾒｲﾄﾝﾈﾙﾀﾞｲｵｰﾄﾞ	共鳴トンネルダイオード	名詞
ｷｮｳﾒｲｼﾞｮｳﾀｲ	共鳴状態	名詞
ｷｮﾘｸｳｶﾝ	距離空間	名詞
ｷｮｾｲﾌﾞﾝﾎｳ	虚成文法	名詞
ｷｮｳｾｲｼﾝﾄﾞｳ	強制振動	名詞
ｷｮｳｾｲﾀｲﾘｭｳ	強制対流	名詞
ｷｮｳｾｷｼｮｳ	共析晶	名詞
ｷｮｳｼﾝﾌﾞﾘｯｼﾞ	共振ブリッジ	名詞
ｷｮｳｼﾝｲﾝﾋﾟｰﾀﾞﾝｽ	共振インピーダンス	名詞
ｷｮｳｼﾝｶｲﾛ	共振回路	名詞
ｷｮｳｼﾝｷ	共振器	名詞
ｷｮｳｼﾝｷｮｸｾﾝ	共振曲線	名詞
ｷｮｳｼﾝｼ	共振子	名詞
ｷｮｳｼﾝｼｭｳﾊｽｳ	共振周波数	名詞
ｷｮｼﾃｷﾀﾞﾝﾒﾝｾｷ	巨視的断面積	名詞
ｷｮｼﾃｷﾍﾝｽｳ	巨視的変数	名詞
ｷｮｼﾃｷﾌｱﾝﾃｲｾｲ	巨視的不安定性	名詞
ｷｮｼﾃｷﾘｮｳｼｶ	巨視的量子化	名詞
ｷｮｳｼｮｳ	共晶	名詞
ｷｮｼｮｳﾃﾝ	虚焦点	名詞
ｷｮｳｼｮｳﾃﾝ	共焦点	名詞
ｷｮｳｼｭｳｿｸ	強集束	名詞
ｷｮｳｼｭｳｿｸｼﾝｸﾛﾄﾛﾝ	強集束シンクロトロン	名詞
ｷｮｳﾀｲｲｷｿﾞｳﾌｸｷ	狭帯域増幅器	名詞
ｷｮｳﾃｲｾｶｲｼﾞ	協定世界時	名詞
ｷｮｳﾂｳﾍﾞｰｽｶｲﾛ	共通ベース回路	名詞
ｷｮｳﾂｳﾄﾞﾚｲﾝｶｲﾛ	共通ドレイン回路	名詞
ｷｮｳﾂｳｴﾐｯﾀｰｶｲﾛ	共通エミッター回路	名詞
ｷｮｳﾂｳｺﾚｸﾀｰｶｲﾛ	共通コレクター回路	名詞
ｷｮｳﾂｳｿｰｽｶｲﾛ	共通ソース回路	名詞
ｷｮｳﾒｲｼﾞｭﾝｲ	共鳴準位	名詞
ｷｮｳﾔｸ	共役	名詞
ｷｮｳﾔｸﾊ	共役波	名詞
ｷｮｳﾔｸｹﾂｺﾞｳ	共役結合	名詞
ｷｮｳﾔｸｺｳｾﾝ	共役光線	名詞
ｷｮｳﾔｸｸｳｶﾝ	共役空間	名詞
ｷｮｳﾔｸﾃﾝ	共役点	名詞
ｷｮｳﾔｸｳﾝﾄﾞｳﾘｮｳ	共役運動量	名詞
ｷｮｳﾔｸｿﾞｳ	共役像	名詞
ｷｮﾖｳﾍﾞｰﾀﾎｳｶｲ	許容β崩壊	名詞
ｷｮﾖｳﾍﾞｰﾀﾎｳｶｲ	許容$\beta$崩壊	名詞
ｷｮﾖｳﾍﾞｰﾀﾎｳｶｲ	許容\beta崩壊	名詞
ｷｮﾖｳﾃﾞﾝﾘｭｳ	許容電流	名詞
ｷｮﾖｳﾊｲｱﾂ	許容背圧	名詞
ｷｮﾖｳﾉｳﾄﾞ	許容濃度	名詞
ｷｮﾖｳｵｳﾘｮｸ	許容応力	名詞
ｷｮﾖｳﾘｰｸﾘｮｳ	許容リーク量	名詞
ｷｮﾖｳｻ	許容差	名詞
ｷｮﾖｳｾﾝｲ	許容遷移	名詞
ｷｮﾖｳｾﾝﾘｮｳ	許容線量	名詞
ｷｮｳﾕｳﾃﾞﾝﾌﾞﾝｲｷ	強誘電分域	名詞
ｷｮｳﾕｳﾃﾞﾝｶﾞﾀｼﾝﾄﾞｳ	強誘電型振動	名詞
ｷｮｳﾕｳﾃﾞﾝｾｲ	強誘電性	名詞
ｷｮｳﾕｳﾃﾞﾝｿｳﾃﾝｲ	強誘電相転移	名詞
ｷｮｳﾕｳﾃﾞﾝﾀｲ	強誘電体	名詞
ｷｮｳﾕｳｹﾞﾝｼｶ	共有原子価	名詞
ｷｮｳﾕｳｺﾞｳｷﾝ	共融合金	名詞
ｷｮｳﾕｳｹｯｼｮｳ	共有結晶	名詞
ｷｮｳﾕｳｹﾂｺﾞｳ	共有結合	名詞
ｷｮｳﾕｳｺｳｿﾞｳ	共有構造	名詞
ｷｮｳﾕｳﾃﾝ	共融点	名詞
ｷｮｳｼﾞﾊﾞ	強磁場	名詞
ｷｮｳｼﾞｾｲ	強磁性	名詞
ｷｮｳｼﾞｾｲｶﾝﾜ	強磁性緩和	名詞
ｷｮｳｼﾞｾｲｷｮｳﾒｲ	強磁性共鳴	名詞
ｷｮｳｼﾞｾｲﾀｲ	強磁性体	名詞
ｷｮｳｼﾞｾｲﾕｳﾃﾞﾝﾀｲ	強磁性誘電体	名詞
ｷｮｳｿﾞｳﾎｳ	鏡像法	名詞
ｷｮｳｿﾞﾝｷｮｸｾﾝ	共存曲線	名詞
ｷｮｳｿﾞｳﾎﾟﾃﾝｼｬﾙ	鏡像ポテンシャル	名詞
ｷｮｳｿﾞｳﾘｮｸ	鏡像力	名詞
ｷｮｳｼﾞｭｳｺﾞｳ	共重合	名詞
ｷｭｳﾍﾞｯｾﾙｶﾝｽｳ	球ベッセル関数	名詞
ｷｭｳｴﾙｺﾞﾝﾊﾝﾉｳ	球エルゴン反応	名詞
ｷｭｳｲﾝｶﾞﾀｺｳｵﾝｹｲ	吸引型高温計	名詞
ｷｭｳｶﾝｽｳ	球関数	名詞
ｷｭｳｹｲｶｸ	球形核	名詞
ｷｭｳｹｲﾓｹｲ	球形模型	名詞
ｷｭｳｹｲﾘｮｳｲｷ	球形領域	名詞
ｷｭｳｺｳﾄﾞ	吸光度	名詞
ｷｭｳｺｳｺｳﾄﾞﾎｳ	吸光光度法	名詞
ｷｭｳﾒﾝﾊ	球面波	名詞
ｷｭｳﾒﾝﾌﾘｺ	球面振り子	名詞
ｷｭｳﾒﾝｹｲ	球面計	名詞
ｷｭｳﾒﾝｷｮｳ	球面鏡	名詞
ｷｭｳﾒﾝｼｭｳｻ	球面収差	名詞
ｷｭｳﾒﾝﾃﾝｿﾙ	球面テンソル	名詞
ｷｭｳﾒﾝﾁｮｳﾜｶﾝｽｳ	球面調和関数	名詞
ｷｭﾑﾗﾝﾄﾃﾝｶｲ	キュムラント展開	名詞
ｷｭｳﾈﾂﾊﾝﾉｳ	吸熱反応	名詞
ｷｭｳﾆｭｳｱﾂ	吸入圧	名詞
ｷｭｳｵﾝｹｲｽｳ	吸音係数	名詞
ｷｭｳｵﾝﾘﾂ	吸音率	名詞
ｷｭｳｵﾝﾘｮｸ	吸音力	名詞
ｷｭｳｵﾝｻﾞｲﾘｮｳ	吸音材料	名詞
ｷｭﾘｰ	Curie	人名
ｷｭﾘｰｿｸ	キュリー則	名詞
ｷｭﾘｰﾉﾎｳｿｸ	キュリーの法則	名詞
ｷｭﾘｰｵﾝﾄﾞ	キュリー温度	名詞
ｷｭﾘｰﾃﾝ	キュリー点	名詞
ｷｭﾘｰﾜｲｽﾉﾎｳｿｸ	キュリー・ワイスの法則	名詞
ｷｭｳｾｲｺｳｶ	急性効果	名詞
ｷｭｳｾｲｼｮｳｼｬ	急性照射	名詞
ｷｭｳｽｳｶｲ	級数解	名詞
ｷｭｳｼｮｳ	球晶	名詞
ｷｭｼｭｳﾊﾞﾝﾄﾞ	吸収バンド	名詞
ｷｭｳｼｭｳﾀﾞﾝﾒﾝｾｷ	吸収断面積	名詞
ｷｭｳｼｭｳｶﾞﾀｼｭｳﾊｹｲ	吸収型周波計	名詞
ｷｭｳｼｭｳｲﾝｼ	吸収因子	名詞
ｷｭｳｼｭｳｶｸﾘﾂ	吸収確率	名詞
ｷｭｳｼｭｳｹｲｽｳ	吸収係数	名詞
ｷｭｳｼｭｳﾓｹｲ	吸収模型	名詞
ｷｭｳｼｭｳﾎﾟﾃﾝｼｬﾙ	吸収ポテンシャル	名詞
ｷｭｳｼｭｳﾚｲﾄｳｻｲｸﾙ	吸収冷凍サイクル	名詞
ｷｭｳｼｭｳﾚｲﾄｳｼｽﾃﾑ	吸収冷凍システム	名詞
ｷｭｳｼｭｳﾘﾂ	吸収率	名詞
ｷｭｳｼｭｳｾﾝﾘｮｳ	吸収線量	名詞
ｷｭｳｼｭｳｵﾝﾄﾞｹｲ	吸収温度計	名詞
ｷｭｳｼｭｳｽﾍﾟｸﾄﾙ	吸収スペクトル	名詞
ｷｭｳｼｭｳﾀｲ	吸収帯	名詞
ｷｭｳｼｭｳﾀﾝ	吸収端	名詞
ｷｭｳﾀｲｼｮｳﾌﾞﾝｼ	球対称分子	名詞
ｷｮｳﾀｲｼｮｳｺﾏﾌﾞﾝｼ	球対称こま分子	名詞
ｷｭｳﾀｲｼｮｳ	球対称	名詞
ｺﾏｶﾞﾀﾌﾞﾝｼ	こま形分子	名詞
ｷｭｳﾁｬｸﾊﾞｲ	吸着媒	名詞
ｷｭｳﾁｬｸｹﾞﾝｼ	吸着原子	名詞
ｷｭｳﾁｬｸﾍｲｺｳ	吸着平衡	名詞
ｷｭｳﾁｬｸｶｸﾘﾂ	吸着確率	名詞
ｷｭｳﾁｬｸｺｳｿﾞｳ	吸着構造	名詞
ｷｭｳﾁｬｸﾈﾂ	吸着熱	名詞
ｷｭｳﾁｬｸﾄｳｵﾝｾﾝ	吸着等温線	名詞
ｷｭﾁｬｸｼﾞｶﾝ	吸着時間	名詞
ｷｭｳｼﾞｮｳｾｲﾀﾞﾝ	球状星団	名詞
ﾗﾑﾀﾞｶﾞﾀﾆｼﾞｭｳﾌﾞﾝﾘ	Λ型二重分離	名詞
ﾗﾑﾀﾞｶﾞﾀﾆｼﾞｭｳﾌﾞﾝﾘ	${\mit\Lambda}$型二重分離	名詞
ﾗﾑﾀﾞｶﾞﾀﾆｼﾞｭｳﾌﾞﾝﾘ	{\mit\Lambda}型二重分離	名詞
ﾗﾑﾀﾞｶﾞﾀﾆｼﾞｭｳｺｳ	Λ型二重項	名詞
ﾗﾑﾀﾞｶﾞﾀﾆｼﾞｭｳｺｳ	${\mit\Lambda}$型二重項	名詞
ﾗﾑﾀﾞｶﾞﾀﾆｼﾞｭｳｺｳ	{\mit\Lambda}型二重項	名詞
ﾗﾑﾀﾞﾃﾝ	λ点	名詞
ﾗﾑﾀﾞﾃﾝ	$\lambda$点	名詞
ﾗﾑﾀﾞﾃﾝ	\lambda点	名詞
ﾗﾑﾀﾞﾃﾝｲ	λ転移	名詞
ﾗﾑﾀﾞﾃﾝｲ	$\lambda$転移	名詞
ﾗﾑﾀﾞﾃﾝｲ	\lambda転移	名詞
LCｱｵｷﾝｼﾞ	LCAO近似	名詞
LCﾊｯｼﾝｷ	LC発振器	名詞
LCｶｲﾛ	LC回路	名詞
Lｶﾞﾀﾆｼﾞｭｳｺｳ	l型二重項	名詞
Lｶﾞﾀﾆｼﾞｭｳｺｳ	{\itl}型二重項	名詞
LSｹﾂｺﾞｳ	LS結合	名詞
LSﾘｮｸ	LS力	名詞
LｯSﾘﾛﾝ	LSS理論	名詞
LSZｹｲｼｷ	LSZ形式	名詞
ﾐｭｰｴﾌﾍﾝｾｲ	μ-e普遍性	名詞
ﾐｭｰｴﾌﾍﾝｾｲ	$\mu$-e普遍性	名詞
ﾐｭｰｴﾌﾍﾝｾｲ	\mu-e普遍性	名詞
ﾐｭｰｸｳｶﾝ	μ空間	名詞
ﾐｭｰｸｳｶﾝ	$\mu$空間	名詞
ﾐｭｰｸｳｶﾝ	\mu空間	名詞
ﾐｭｰﾆｭｰﾄﾘﾉ	μニュートリノ	名詞
ﾐｭｰﾆｭｰﾄﾘﾉ	$\mu$ニュートリノ	名詞
ﾐｭｰﾆｭｰﾄﾘﾉ	\muニュートリノ	名詞
ﾐｭｰﾘｭｳｼ	μ粒子	名詞
ﾐｭｰﾘｭｳｼ	$\mu$粒子	名詞
ﾐｭｰﾘｭｳｼ	\mu粒子	名詞
ﾐｭｰﾘｭｳｼｹﾞﾝｼ	μ粒子原子	名詞
ﾐｭｰﾘｭｳｼｹﾞﾝｼ	$\mu$粒子原子	名詞
ﾐｭｰﾘｭｳｼｹﾞﾝｼ	\mu粒子原子	名詞
ﾐｭｰﾘｭｳｼﾎｶｸ	μ粒子捕獲	名詞
ﾐｭｰﾘｭｳｼﾎｶｸ	$\mu$粒子捕獲	名詞
ﾐｭｰﾘｭｳｼﾎｶｸ	\mu粒子捕獲	名詞
ﾐｭｰﾘｭｳｼｽﾋﾟﾝｶｲﾃﾝ	μ粒子スピン回転	名詞
ﾐｭｰﾘｭｳｼｽﾋﾟﾝｶｲﾃﾝ	$\mu$粒子スピン回転	名詞
ﾐｭｰﾘｭｳｼｽﾋﾟﾝｶｲﾃﾝ	\mu粒子スピン回転	名詞
ﾐｭｰﾘｭｳｼｽﾋﾟﾝｷｮｳﾒｲ	μ粒子スピン共鳴	名詞
ﾐｭｰﾘｭｳｼｽﾋﾟﾝｷｮｳﾒｲ	$\mu$粒子スピン共鳴	名詞
ﾐｭｰﾘｭｳｼｽﾋﾟﾝｷｮｳﾒｲ	\mu粒子スピン共鳴	名詞
ﾐSｺｳｿﾞｳ	MIS構造	名詞
MKｻﾀﾝｲｹｲ	MKSA単位系	名詞
MKSﾀﾝｲｹｲ	MKS単位系	名詞
MﾉSｺｳｿﾞｳ	MNOS構造	名詞
ﾓﾎｳ	MO法	名詞
ﾓS	MOS	名詞
ﾓSﾀﾞｲｵｰﾄﾞ	MOSダイオード	名詞
ﾓSﾃﾞﾝｶｲｺｳｶ	MOS電界効果	名詞
ﾓSｺｳｿﾞｳ	MOS構造	名詞
ﾓｯｼｭｳｾｷｶｲﾛ	MOS集積回路	名詞
Mﾁｭｳｼﾝ	M中心	名詞
ﾏｰﾃﾞﾙﾝｸﾞﾃｲｽｳ	マーデルング定数	名詞
ﾏﾌｨﾝﾃｨﾝﾎﾟﾃﾝｼｬﾙ	マフィン・ティンポテンシャル	名詞
ﾏｹﾞｺﾞｳｾｲ	曲げ剛性	名詞
ﾏｹﾞﾓｰﾒﾝﾄ	曲げモーメント	名詞
ﾏｹﾞｼﾝﾄﾞｳ	曲げ振動	名詞
ﾏｹﾞﾂﾖｻ	曲げ強さ	名詞
ﾏｸﾞﾃﾞﾌﾞﾙｸﾉﾊﾝｷｭｳ	マグデブルクの半球	名詞
ﾏｸﾞﾈﾘｺｳｿﾞｳ	マグネリ構造	名詞
ﾏｸﾞﾈﾃｨｯｸ	マグネティック	名詞
ﾌﾞﾚｰｸﾀﾞｳﾝ	ブレークダウン	名詞
ﾏｸﾞﾈﾄﾝ	マグネトン	名詞
ﾏｸﾞﾈﾄﾛﾝ	マグネトロン	名詞
ﾏｸﾞﾈﾄﾛﾝｹﾞｰｼﾞ	マグネトロンゲージ	名詞
ﾏｸﾞﾉﾝ	マグノン	名詞
ﾏｸﾞﾉﾝｺｳｶ	マグノン効果	名詞
ﾏｸﾞﾇｽｺｳｶ	マグヌス効果	名詞
ﾏｯﾊｴﾝｽｲ	マッハ円錐	名詞
ﾏｯﾊﾊ	マッハ波	名詞
ﾏｯﾊｶｸ	マッハ角	名詞
ﾏｯﾊﾉｹﾞﾝﾘ	マッハの原理	名詞
ﾏｯﾊｾﾝ	マッハ線	名詞
ﾏｯﾊｽｳ	マッハ数	名詞
ﾏｯﾊﾂｪﾝﾀﾞｰｶﾝｼｮｳｹｲ	マッハ・ツェンダー干渉計	名詞
ﾏﾎｳｽｳ	魔法数	名詞
ﾏｲｶｺﾝﾃﾞﾝｻｰ	マイカコンデンサー	名詞
ﾏｲｹﾙｿﾝ	マイケルソン	人名
ﾏｲｹﾙｿﾝ	Michelson	人名
ﾏｲｹﾙｿﾝｶﾝｼｮｳｹｲ	マイケルソン干渉計	名詞
ｺｳｾｲｶﾝｼｮｳｹｲ	恒星干渉計	名詞
ﾏｲｹﾙｿﾝﾓｰﾘｰﾉｼﾞｯｹﾝ	マイケルソン・モーリーの実験	名詞
ﾏｲｸﾛﾋﾞｰﾑ	マイクロビーム	名詞
ﾏｲｸﾛﾃﾞﾝｷｮｸ	マイクロ電極	名詞
ﾏｲｸﾛﾄﾞｼﾒﾄﾘｰ	マイクロドシメトリー	名詞
ﾏｲｸﾛﾊ	マイクロ波	名詞
ﾏｲｸﾛﾊﾌﾞﾝｺｳﾎｳ	マイクロ波分光法	名詞
ﾏｲｸﾛﾊﾀﾞｲｵｰﾄﾞ	マイクロ波ダイオード	名詞
ﾏｲｸﾛﾊﾃﾞﾝｼｶﾝ	マイクロ波電子管	名詞
ﾏｲｸﾛﾊﾌｱﾝﾃｲｾｲ	マイクロ波不安定性	名詞
ﾏｲｸﾛﾊｶﾈﾂ	マイクロ波加熱	名詞
ﾏｲｸﾛﾊﾄﾗﾝｼﾞｽﾀｰ	マイクロ波トランジスター	名詞
ﾏｲｸﾛﾊﾁｮｳｵﾝﾊﾟ	マイクロ波超音波	名詞
ﾏｲｸﾛﾒｰﾀｰ	マイクロメーター	名詞
ﾏｲｸﾛﾄﾛﾝ	マイクロトロン	名詞
ﾏｲｽﾅｰｺｳｶ	マイスナー効果	名詞
ﾏｲｽﾅｰﾄﾗｯﾌﾟ	マイスナートラップ	名詞
ﾏｲﾔｰﾉｶﾝｹｲ	マイヤーの関係	名詞
ﾏｷｾﾝﾃｲｺｳｷ	巻線抵抗器	名詞
ﾏｯｷﾝﾚｰﾌｪｯｼｭﾊﾞｯﾊ	マッキンレー・フェッシュバッハ	人名
ｻﾝﾗﾝｺｳｼｷ	散乱公式	名詞
ﾏｯｸﾎｳ	マック法	名詞
ﾏｸﾃﾞﾝｲ	膜電位	名詞
ﾏｸﾍｲｺｳ	膜平衡	名詞
ﾏｸｺｳｿﾞｳ	膜構造	名詞
ﾏｸﾛｰﾄﾞｼﾝｸｳｹｲ	マクロード真空計	名詞
ﾏｸﾛｰﾘﾝﾀﾞｴﾝﾀｲ	マクローリンだ円体	名詞
ﾏｸﾛｰﾘﾝﾀﾞｴﾝﾀｲ	マクローリン楕円体	名詞
ﾀﾞｴﾝﾀｲ	だ円体	名詞
ﾀﾞｴﾝﾀｲ	楕円体	名詞
ﾏｸｽｳｪﾙ	Maxwell	人名
ﾏｯｸｽｳｪﾙ	マクスウェル	人名
ﾏｸｽｳｪﾙｱﾝﾍﾟｰﾙ	マクスウェル・アンペール	人名
ﾏｸｽｳｪﾙﾎﾞﾙﾂﾏﾝ	マクスウェル・ボルツマン	名詞
ﾏｸｽｳｪﾙﾌﾞﾝﾌﾟ	マクスウェル分布	名詞
ﾏｸｽｳｪﾙﾌﾞｯﾀｲ	マクスウェル物体	名詞
ﾏｸｽｳｪﾙﾎｳﾃｲｼｷ	マクスウェル方程式	名詞
ﾏｸｽｳｪﾙﾓｹｲ	マクスウェル模型	名詞
ﾏｸｽｳｪﾙﾉﾃﾞﾓﾝ	マクスウェルのデモン	名詞
ﾏｸｽｳｪﾙﾉﾎｳﾃｲｼｷ	マクスウェルの方程式	名詞
ﾏｸｽｳｪﾙﾉｶﾝｹｲｼｷ	マクスウェルの関係式	名詞
ﾏｸｽｳｪﾙﾉｵｳﾘｮｸ	マクスウェルの応力	名詞
ｿｸﾄﾞﾌﾞﾝﾌﾟｿｸ	速度分布則	名詞
ﾏﾝﾃﾞﾙｽﾀﾑﾍﾝｽｳ	マンデルスタム変数	名詞
ﾏﾝﾃﾞﾙｽﾀﾑﾋｮｳｼﾞ	マンデルスタム表示	名詞
ﾏﾝｶﾞﾝﾊﾞｽ	マンガンバス	名詞
ﾏﾆﾌﾟﾚｰﾀｰ	マニプレーター	名詞
ﾏﾆﾋﾟｭﾚｰﾀｰ	マニピュレーター	名詞
ﾏﾉｽﾀｯﾄ	マノスタット	名詞
ﾏﾝｾｲｺｳｶ	慢性効果	名詞
ﾏﾝｾｲｼｮｳｼｬ	慢性照射	名詞
ﾏﾙｺﾌｶﾃｲ	マルコフ過程	名詞
ﾏﾙｺﾌｻ	マルコフ鎖	名詞
ﾏﾙﾒｺﾞｻ	丸め誤差	名詞
ﾏﾙﾀｰｺｳｶ	マルター効果	名詞
ﾏﾙﾀﾝﾘｮｳｲｷ	マルタン領域	名詞
ﾏﾙﾃﾝｻｲﾄ	マルテンサイト	名詞
ﾏﾙﾃﾝｻｲﾛﾍﾝﾀｲ	マルテンサイト変態	名詞
ﾏﾙﾁﾊﾟｸﾀｰﾘﾝｸﾞ	マルチパクターリング	名詞
ﾏﾙﾁﾌﾟﾚｯｸｽﾉﾘﾄｸ	マルチプレックスの利得	名詞
ﾏﾙﾁｽﾘｯﾄﾌﾞﾝｺｳﾎｳ	マルチスリット分光法	名詞
ﾌﾞﾝｺｳﾎｳ	分光法	名詞
ﾏﾙﾁﾁｬﾈﾙ	マルチチャネル	名詞
ﾏﾙﾁﾜｲﾔｰﾁｪﾝﾊﾞｰ	マルチワイヤーチェンバー	名詞
ﾏﾘｭｽﾉﾎｳｿｸ	マリュスの法則	名詞
ﾏｻﾂﾃﾞﾝｷ	摩擦電気	名詞
ﾏｻﾂｶｸ	摩擦角	名詞
ﾏｻﾂｹｲｽｳ	摩擦係数	名詞
ﾏｻﾂﾉﾎｳｿｸ	摩擦の法則	名詞
ﾏｻﾂｵﾝ	摩擦音	名詞
ﾏｻﾂﾙﾐﾈｾﾝｽ	摩擦ルミネセンス	名詞
ﾏｻﾂｼｲﾝ	摩擦子音	名詞
ﾏｻﾂｼﾝﾄﾞｳ	摩擦振動	名詞
ﾏｻﾂﾃｲｺｳ	摩擦抵抗	名詞
ﾏｯｾｲﾉﾊﾝﾍﾞﾂｷｼﾞｭﾝ	マッセイの判別基準	名詞
ﾏｽﾌｨﾙﾀｰ	マスフィルター	名詞
ﾏｽｷﾝｸﾞ	マスキング	名詞
ﾏｰｽﾛﾌﾉﾃｲﾘ	マースロフの定理	名詞
ﾏｽｼｪﾙ	マスシェル	名詞
ﾏｽﾀｰﾎｳﾃｲｼｷ	マスター方程式	名詞
ﾏﾃｨｱｽﾉﾎｳｿｸ	マティアスの法則	名詞
ﾏﾃｨｰｾﾝﾉｷｿｸ	マティーセンの規則	名詞
ﾏｯﾀﾝｶﾝｷｮﾘ	末端間距離	名詞
ﾏｯﾁﾝｸﾞ	マッチング	名詞
ﾏﾁｭｰｶﾝｽｳ	マチュー関数	名詞
ﾏﾖﾗﾅ	マヨナラ	人名
ﾏﾖﾅﾗ	Majorana	人名
ﾏﾖﾅﾗﾊﾞ	マヨナラ場	名詞
ﾏﾖﾅﾗﾘｮｸ	マヨナラ力	名詞
ﾏﾖﾅﾗﾘｭｳｼ	マヨナラ粒子	名詞
ﾏﾖﾅﾗｽﾋﾟﾉﾙ	マヨナラスピノル	名詞
ﾏｼﾞｯｸﾊﾝﾄﾞ	マジックハンド	名詞
ﾒｰﾊﾞｰ	メーバー	名詞
ﾒｲｺｳ	迷光	名詞
ﾒｲﾘｮｳﾄﾞ	明りょう度	名詞
ﾒｲｼｷｮﾘ	明視距離	名詞
ﾒｲｼﾔｿﾞｳ	明視野像	名詞
ﾒｲｼｮｼ	明所視	名詞
ﾒｶﾆｶﾙﾌｨﾙﾀｰ	メカニカルフィルター	名詞
ﾒｶﾉｹﾐｶﾙｼｽﾃﾑ	メカノケミカルシステム	名詞
ﾒｶﾉｹﾐｽﾄﾘｰ	メカノケミストリー	名詞
ﾒﾓﾘｴﾝﾊﾞﾝ	目盛円盤	名詞
ﾒﾓﾘｻﾀﾞﾒ	目盛定め	名詞
ﾒﾝﾃﾞﾝｶ	面電荷	名詞
ﾒﾝﾃﾞﾝﾘｭｳ	面電流	名詞
ﾒﾆｽｶｽ	メニスカス	名詞
ﾒﾝｶｸ	面角	名詞
ﾒﾝｶｸﾌﾍﾝﾉﾎｳｿｸ	面角不変の法則	名詞
ﾒﾝｶｸｲｯﾃｲﾉﾎｳｿｸ	面角一定の法則	名詞
ﾒﾝｶﾝｶｸ	面間隔	名詞
ﾒﾝｹｯｶﾝ	面欠陥	名詞
ﾒﾝﾐﾂﾄﾞ	面密度	名詞
ﾒﾝｾｷﾌﾞﾝ	面積分	名詞
ﾒﾝｾｷｿｸﾄﾞ	面積速度	名詞
ﾒﾝｼﾝｺｳｼ	面心格子	名詞
ﾒﾝｼﾝﾘｯﾎﾟｳｺｳｼ	面心立方格子	名詞
ﾒﾗｰｻﾝﾗﾝ	メラー散乱	名詞
ﾒﾘｼﾞｵﾅﾙｺｳｾﾝ	メリジオナル光線	名詞
ﾒﾙ	メル	名詞
ﾒﾙﾃﾞﾉｼﾞｯｹﾝ	メルデの実験	名詞
ﾒﾙﾄﾚｵﾛｼﾞｰ	メルトレオロジー	名詞
ﾒｻｶﾞﾀﾄﾗﾝｼﾞｽﾀｰ	メサ型トランジスター	名詞
ﾒｿﾝﾌｧｸﾄﾘｰ	メソンファクトリー	名詞
ﾒｽﾊﾞｳｱｰﾌﾞﾝｺｳ	メスバウアー分光	名詞
ﾒｽﾊﾞｳｱｰﾌﾞﾝｺｳﾎｳ	メスバウアー分光法	名詞
ﾒｽﾊﾞｳｱｰｺｳｶ	メスバウアー効果	名詞
ﾒﾀｾﾝﾀｰ	メタセンター	名詞
ﾒﾀｼﾞｾｲ	メタ磁性	名詞
ﾒｰｻﾞｰ	メーザー	名詞
ﾐﾀﾞﾚﾉｽｹｰﾙ	乱れのスケール	名詞
ﾐﾀﾞﾚﾀｹｲ	乱れた系	名詞
ﾐﾀﾞﾚﾀﾌﾟﾗｽﾞﾏ	乱れたプラズマ	名詞
ﾐｷﾞｴﾝﾍﾝｺｳ	右円偏光	名詞
ﾐｷﾞﾈｼﾞﾉﾎｳｿｸ	右ねじの法則	名詞
ﾐｷﾞﾃﾉｷｿｸ	右手の規則	名詞
ﾐｸﾞﾀﾞﾙｷﾝｼﾞ	ミグダル近似	名詞
ﾐﾊｴﾘｽﾒﾝﾃﾝﾉｼｷ	ミハエリス・メンテンの式	名詞
ﾐｰｻﾝﾗﾝ	ミー散乱	名詞
ﾐｶｹﾉﾎﾞｳﾁｮｳ	見掛けの膨張	名詞
ﾐｶｹﾉｼﾂﾘｮｳ	見掛けの質量	名詞
ﾐｶｹﾉﾁｶﾗ	見掛けの力	名詞
ﾐｶｹﾉﾄｳｷｭｳ	見掛けの等級	名詞
ﾐｸﾛｼﾞｷｶﾞｸ	ミクロ磁気学	名詞
ﾐﾆﾏｯｸｽｹﾞﾝﾘ	ミニマックス原理	名詞
ﾐﾆﾏｯｸｽｹｯﾃｲ	ミニマックス決定	名詞
ﾐﾆﾏｯｸｽｷﾝｼﾞ	ミニマックス近似	名詞
ﾐﾆﾏﾙｿｳｺﾞｻﾖｳ	ミニマルな相互作用	名詞
ﾐﾝｺﾌｽｷｰﾉｼﾞｸｳ	ミンコフスキーの時空	名詞
ﾐｯﾌﾟｳｾﾝｹﾞﾝ	密封線源	名詞
ﾐｯﾌﾟｳﾀﾝｼ	密封端子	名詞
ﾐﾗｰﾋ	ミラー比	名詞
ﾐﾗｰｺｳｶ	ミラー効果	名詞
ﾐﾗｰﾉｼﾞｯｹﾝ	ミラーの実験	名詞
ﾐﾗｰｾｷﾌﾞﾝｷ	ミラー積分器	名詞
ﾐﾗｰｼｽｳ	ミラー指数	名詞
ﾐﾗｰｼﾞﾊﾞ	ミラー磁場	名詞
ﾐﾘｶﾝﾉﾕﾃｷﾉｼﾞｯｹﾝ	ミリカンの油滴の実験	名詞
ﾐﾙｷﾝｸﾞ	ミルキング	名詞
ﾐｾﾙｺﾛｲﾄﾞ	ミセルコロイド	名詞
ﾐｼﾋﾞﾘﾃｨｷﾞｬｯﾌﾟ	ミシビリティギャップ	名詞
ﾐｯｼﾝｸﾞﾏｽ	ミッシングマス	名詞
ﾐｼｪﾙﾊﾟﾗﾒｰﾀｰ	ミシェルパラメーター	名詞
ﾐﾂﾄﾞｷﾞｮｳﾚﾂ	密度行列	名詞
ﾐﾂﾄﾞﾊ	密度波	名詞
ﾐﾂﾄﾞﾊﾝｶﾝｽｳ	密度汎関数	名詞
ﾐﾂﾄﾞﾍﾝﾁｮｳ	密度変調	名詞
ﾐﾂﾄﾞｺｳﾊﾞｲﾎｳ	密度勾配法	名詞
ﾐﾂﾄﾞｺｳﾊﾞｲﾌｱﾝﾃｲｾｲ	密度勾配不安定性	名詞
ﾐﾂﾄﾞﾘｭｳ	密度流	名詞
ﾐｽﾞﾌｶ	水負荷	名詞
ﾐｽﾞﾈﾂﾘｮｳｹｲ	水熱量計	名詞
ﾐｽﾞﾄｳﾘｮｳ	水当量	名詞
ﾓｰ	モー	名詞
ﾓｱﾚｼﾞﾏ	モアレじま	名詞
ﾓｱﾚｽﾞｹｲ	モアレ図形	名詞
ﾓｰﾄﾞﾌﾞﾝﾌﾟ	モード分布	名詞
ﾓｰﾄﾞﾄﾞｳｷ	モード同期	名詞
ﾓｰﾄﾞﾄﾞｳｷﾚｰｻﾞｰ	モード同期レーザー	名詞
ﾓｰﾄﾞｹﾂｺﾞｳ	モード結合	名詞
ﾓｰﾄﾞﾊﾟﾀｰﾝ	モードパターン	名詞
ﾓｰﾄﾞﾌﾟﾘﾝｸﾞ	モードプリング	名詞
ﾓｰﾄﾞﾌﾟｯｼﾝｸﾞ	モードプッシング	名詞
ﾓｰﾄﾞｾﾝﾀｸ	モード選択	名詞
ﾓｰﾄﾞｻﾞﾂｵﾝ	モード雑音	名詞
ﾓﾌｧｯﾄｳｽﾞ	モファット渦	名詞
ﾓﾌｨｯﾄﾔﾝﾉｼｷ	モフィット・ヤンの式	名詞
ﾓｳﾊﾂｼﾂﾄﾞｹｲ	毛髪湿度計	名詞
ﾓﾎﾌﾚﾝｿﾞｸﾒﾝ	モホ不連続面	名詞
ﾓﾎﾛﾋﾞﾁｯﾁﾌﾚﾝｿﾞｸﾒﾝ	モホロビチッチ不連続面	名詞
ﾓｳｶﾝｹﾞﾝｼｮｳ	毛管現象	名詞
ﾓｰﾒﾝﾄﾃﾝｶｲ	モーメント展開	名詞
ﾓｰﾒﾝﾄ	モーメント	名詞
ﾓﾝｺﾞﾒﾘｰﾎｳ	モンゴメリー法	名詞
ﾓﾝｷｰﾊﾝﾃｨﾝｸﾞ	モンキーハンティング	名詞
ﾓﾉﾌｨﾗﾒﾝﾄ	モノフィラメント	名詞
ﾓﾉｸﾛﾒｰﾀｰ	モノクロメーター	名詞
ﾓﾉﾎﾟｰﾙ	モノポール	名詞
ﾓﾉﾎﾟｰﾙｶﾞﾀ	モノポール型	名詞
ﾓﾉﾘｼｯｸｶｲﾛ	モノリシック回路	名詞
ﾓﾝﾃｶﾙﾛﾎｳ	モンテカルロ法	名詞
ﾓｰﾍﾟﾙﾃｭｲﾉｹﾞﾝﾘ	モーペルテュイの原理	名詞
ﾓﾚﾃﾞﾝﾘｭｳ	漏れ電流	名詞
ﾓﾚﾍﾝｱﾂｷ	漏れ変圧器	名詞
ﾓﾚｹﾝｼｭﾂｷ	漏れ検出器	名詞
ﾓﾚｷｭﾗｰｼｰﾌﾞ	モレキュラーシーブ	名詞
ﾓﾚｼﾞﾊﾞ	漏れ磁場	名詞
ﾓﾘｴｰﾙﾎﾟﾃﾝｼｬﾙ	モリエールポテンシャル	名詞
ﾓﾘｴｰｾﾝｽﾞ	モリエー線図	名詞
ﾓﾙﾌﾞﾝｷｮｸ	モル分極	名詞
ﾓﾙﾌﾞﾝﾘﾂ	モル分率	名詞
ﾓﾙﾌﾞﾝｼｽｳ	モル分子数	名詞
ﾓﾙﾃﾞﾝﾄﾞｳﾘﾂ	モル伝導率	名詞
ﾓﾙﾋﾈﾂ	モル比熱	名詞
ﾓﾙﾋﾘｮｳ	モル比量	名詞
ﾓﾙｷｭｳｺｳｹｲｽｳ	モル吸光係数	名詞
ﾓﾙﾉｳﾄﾞ	モル濃度	名詞
ﾓｰﾙﾉｵｳﾘｮｸｴﾝ	モールの応力円	名詞
ﾓﾙｵﾝｿｸﾄﾞ	モル音速度	名詞
ﾓﾙﾀｲｾｷ	モル体積	名詞
ﾓﾙｼﾞｶﾘﾂ	モル磁化率	名詞
ﾓｰｽｶﾀｻ	モース硬さ	名詞
ﾓｰｽﾎﾟﾃﾝｼｬﾙ	モースポテンシャル	名詞
ﾓｯﾄｻﾝﾗﾝ	モット散乱	名詞
ﾓｯﾄﾃﾝｲ	モット転移	名詞
ﾓｯﾄｾﾞﾂｴﾝﾀｲ	モット絶縁体	名詞
ﾓｻﾞｲｸｹｯｼｮｳ	モザイク結晶	名詞
ﾓｻﾞｲｸｺｳｿﾞｳ	モザイク構造	名詞
ﾓｰｽﾞﾘｰﾉﾎｳｿｸ	モーズリーの法則	名詞
ﾓｼﾞｭﾚｰﾀｰｹﾞｰｼﾞ	モジュレーターゲージ	名詞
ﾑﾃﾞﾝｷｮｸﾎｳﾃﾞﾝ	無電極放電	名詞
ﾑｹﾞﾝｼｮｳﾍﾝｶﾝ	無限小変換	名詞
ﾑｹﾞﾝｼｮｳｶｲﾃﾝ	無限小回転	名詞
ﾑｹﾞﾝｳﾝﾄﾞｳﾘｮｳｹｲ	無限運動量系	名詞
ﾑﾊﾝｼｬｼｭｳﾀﾝ	無反射終端	名詞
ﾑﾊﾝﾁｮｳｶﾞﾝﾏｾﾝﾎｳｼｬ	無反跳γ線放射	名詞
ﾑﾊﾝﾁｮｳｶﾞﾝﾏｾﾝﾎｳｼｬ	無反跳$\gamma$線放射	名詞
ﾑﾊﾝﾁｮｳｶﾞﾝﾏｾﾝﾎｳｼｬ	無反跳\gamma線放射	名詞
ﾑﾊﾝﾁｮｳ	無反跳	名詞
ｶﾞﾝﾏｾﾝｷｭｳｼｭｳ	γ線吸収	名詞
ｶﾞﾝﾏｾﾝｷｭｳｼｭｳ	$\gamma$線吸収	名詞
ｶﾞﾝﾏｾﾝｷｭｳｼｭｳ	\gamma線吸収	名詞
ﾑﾊﾝﾁｮｳﾎｳｼｬ	無反跳放射	名詞
ﾑﾊﾝﾁｮｳｾﾝｲ	無反跳遷移	名詞
ﾑﾎｳｼｬｾﾝｲ	無放射遷移	名詞
ﾑｶｴｶｸ	迎え角	名詞
ﾑｺｳﾃﾞﾝﾘｮｸ	無効電力	名詞
ﾑｺｳﾃﾞﾝﾘｭｳ	無効電流	名詞
ﾑｷｮｸｾｲﾌﾞﾝｼ	無極性分子	名詞
ﾑｷｮｳｼﾂ	無響室	名詞
ﾑｰﾆｰﾈﾝﾄﾞ	ムーニー粘度	名詞
ﾑｵﾝｲｷ	無音域	名詞
ﾑｾｲｵﾝ	無声音	名詞
ﾑｾｯﾃﾝｽｲｯﾁ	無接点スイッチ	名詞
ﾑｽﾒｶｸ	娘核	名詞
ﾑｽﾒｶｸｼｭ	娘核種	名詞
ﾑｼｮｳﾄﾂﾌﾟﾗｽﾞﾏ	無衝突プラズマ	名詞
ﾑｼｮｳﾄﾂｼｮｳｹﾞｷﾊ	無衝突衝撃波	名詞
ﾑﾃｲｲ	無定位	連体詞
ﾑﾁﾂｼﾞｮﾄﾞ	無秩序度	名詞
ﾑﾁﾂｼﾞｮｹｲ	無秩序系	名詞
ﾑﾁﾂｼﾞｮｳﾝﾄﾞｳ	無秩序運動	名詞
ﾑﾁｮｳｾｲﾊｯｼﾝｶｲﾛ	無調整発振回路	名詞
ﾑﾕｳﾄﾞｳﾃｲｺｳ	無誘導抵抗	名詞
ﾑﾕｳﾄﾞｳﾃｲｺｳｷ	無誘導抵抗器	名詞
ﾑｼﾞｹﾞﾝﾘｮｳ	無次元量	名詞
ﾑｼﾞｭｳﾘｮｸｼﾞｮｳﾀｲ	無重力状態	名詞
ﾐｬｸﾄﾞｳﾃﾞﾝﾘｭｳ	脈動電流	名詞
ﾐｬｸﾘｭｳ	脈流	名詞
ﾐｭｰｵﾆｳﾑ	ミューオニウム	名詞
ﾐｭﾗｰｷﾞｮｳﾚﾂ	ミュラー行列	名詞
ﾅﾋﾞｴｽﾄｰｸｽﾉﾎｳﾃｲｼｷ	ナビエ・ストークスの方程式	名詞
ﾅｶﾞｵｶﾉｹﾞﾝｼﾓｹｲ	長岡の原子模型	名詞
ﾅｶﾞﾚｶﾝｽｳ	流れ関数	名詞
ﾅｶﾞﾚﾐﾂﾄﾞ	流れ密度	名詞
ﾅｶﾞﾚﾉｶｼｶ	流れの可視化	名詞
ﾅｲﾌﾞﾃﾞﾝｼﾂｲｾｲｾｲ	内部電子対生成	名詞
ﾅｲﾌﾞﾄﾞｳﾀｲｹｲ	内部導体系	名詞
ﾅｲﾌﾞｴﾈﾙｷﾞｰ	内部エネルギー	名詞
ﾅｲﾌﾞｴﾝｽｲｸｯｾﾂ	内部円錐屈折	名詞
ﾅｲﾌﾞﾊ	内部波	名詞
ﾅｲﾌﾞﾋﾊﾞｸ	内部被爆	名詞
ﾅｲﾌﾞｲﾝﾋﾟｰﾀﾞﾝｽ	内部インピーダンス	名詞
ﾅｲﾌﾞｶｲ	内部解	名詞
ﾅｲﾌﾞｺｳﾃﾞﾝｺｳｶ	内部光電効果	名詞
ﾅｲﾌﾞﾏｻﾂ	内部摩擦	名詞
ﾅｲﾌﾞﾈﾝｾｲ	内部粘性	名詞
ﾅｲﾌﾞﾘｮｳｼｽｳ	内部量子数	名詞
ﾅｲﾌﾞｾｲﾄﾞｳﾎｳｼｬ	内部制動放射	名詞
ﾅｲﾌﾞｾﾝﾘｮｳ	内部線量	名詞
ﾅｲﾌﾞｼｮｳｼｬ	内部照射	名詞
ﾅｲﾌﾞﾀｰｹﾞｯﾄ	内部ターゲット	名詞
ﾅｲﾌﾞﾃｲｺｳ	内部抵抗	名詞
ﾅｲﾌﾞﾃﾝｶﾝ	内部転換	名詞
ﾅｲﾌﾞﾃﾝｶﾝｹｲｽｳ	内部転換係数	名詞
ﾅｲﾌﾞｻﾞﾂｵﾝ	内部雑音	名詞
ﾅｲﾌﾞｼﾞﾊﾞ	内部磁場	名詞
ﾅｲﾋｮｳｼﾞｭﾝﾎｳ	内標準法	名詞
ﾅｲｷｮｳｼﾞｭﾝｾﾝ	内標準線	名詞
ﾅｲｶｸﾃﾞﾝﾘ	内殻電離	名詞
ﾅｲｶｸﾃﾞﾝｼ	内殻電子	名詞
ﾅｲｷｽﾄ	ナイキスト	人名
ﾅｲｷｽﾄ	Nyquist	人名
ﾅｲｷｽﾄﾉｱﾝﾃｲｼﾞｮｳｹﾝ	ナイキストの安定条件	名詞
ﾅｲｷｽﾄﾉﾃｲﾘ	ナイキストの定理	名詞
ﾅｲｷｽﾄｾﾝｽﾞ	ナイキスト線図	名詞
ﾅｲﾘｮｸ	内力	名詞
ﾅｲｾｷ	内積	名詞
ﾅｲｿｳ	内挿	名詞
ﾅｲﾄｼﾌﾄ	ナイトシフト	名詞
ﾅｶﾉﾆｼｼﾞﾏｹﾞﾙﾏﾝ	中野・西島・ゲルマン	人名
ﾅﾏﾘﾁｸﾃﾞﾝﾁ	鉛蓄電池	名詞
ﾅﾒﾗｶﾅｿｸﾊﾞｸ	滑らかな束縛	名詞
ﾅﾐﾃｲｺｳ	波抵抗	名詞
ﾅﾅﾒﾉｼｮｳｹﾞｷﾊ	斜めの衝撃波	名詞
ﾅﾝﾌﾞｺﾞｰﾙﾄﾞｽﾄｰﾝ	南部・ゴールドストーン	名詞
ﾅﾝﾌﾞｼﾞｮﾅﾗｼﾞﾆｵﾓｹｲ	南部・ジョナラジニオ模型	名詞
ﾅﾝｶﾃﾝ	軟化点	名詞
ﾅﾝｾｲﾌﾞﾝ	軟成分	名詞
ﾅﾝｼﾞｾｲｻﾞｲﾘｮｳ	軟磁性材料	名詞
ﾅﾝｼﾂｼﾞｾｲｻﾞｲﾘｮｳ	軟質磁性材料	名詞
ﾅﾝXｾﾝ	軟X線	名詞
ﾅﾄﾘｳﾑﾗﾝﾌﾟ	ナトリウムランプ	名詞
ﾅﾁｭﾗﾙﾊﾟﾘﾃｨ	ナチュラルパリティ	名詞
ﾈｯｶﾝｶｺｳ	熱間加工	名詞
ﾈｯｷﾝｸﾞ	ネッキング	名詞
ﾈｸﾀｲｽﾞ	ネクタイ図	名詞
ﾈﾏﾁｯｸｿｳ	ネマチック相	名詞
ﾈﾑﾘｺﾞﾏ	眠りごま	名詞
ﾈﾝﾀﾞｲｿｸﾃｲ	年代測定	名詞
ﾈﾝﾀﾞﾝｾｲ	粘弾性	名詞
ﾈﾝﾀﾞﾝｾｲﾘｭｳﾀｲ	粘弾性流体	名詞
ﾈﾝﾄﾞﾍｲｷﾝﾌﾞﾝｼﾘｮｳ	粘度平均分子量	名詞
ﾈﾝﾄﾞｹｲ	粘度計	名詞
ﾈﾝﾘｮｳﾃﾞﾝﾁ	燃料電池	名詞
ﾈﾝﾘｮｳｵﾔﾌﾞｯｼﾂ	燃料親物質	名詞
ﾈﾝｾｲﾘﾂ	粘性率	名詞
ﾈﾝｾｲﾘｭｳ	粘性流	名詞
ﾈﾝｾｲﾘｭｳﾀｲ	粘性流体	名詞
ﾈﾝｾｲｼﾝｸｳｹｲ	粘性真空計	名詞
ﾈﾝｾｲﾃｲｺｳ	粘性抵抗	名詞
ﾈﾝｼｮｳﾄﾞ	燃焼度	名詞
ﾈﾝｼｮｳﾎｳﾃｲｼｷ	燃焼方程式	名詞
ﾈﾝｼｮｳﾈﾂ	燃焼熱	名詞
ﾈﾝｼｮｳﾃﾝ	燃焼点	名詞
ﾈﾝｼｭｳｼｻ	年周視差	名詞
ﾈｵﾝﾎﾄﾞｽｺｰﾌﾟ	ネオンホドスコープ	名詞
ﾈｵﾝﾗﾝﾌﾟ	ネオンランプ	名詞
ﾈｵﾝﾄﾗﾝｽ	ネオントランス	名詞
ﾈｰﾊﾞ	ネーバ	名詞
ﾈﾌﾟﾂﾆｳﾑｹｲﾚﾂ	ネプツニウム系列	名詞
ﾈﾚﾝﾍﾞﾙｸﾉﾍﾝｺｳｷ	ネレンベルクの偏光器	名詞
ﾈｰﾙﾍｷ	ネール壁	名詞
ﾈﾙﾝｽﾄ	ネルンスト	人名
ﾈﾙﾝｽﾄ	Nernst	人名
ｴｯﾃｨﾝｸﾞｽﾊｳｾﾞﾝｺｳｶ	・エッティングスハウゼン効果	名詞
ﾈﾙﾝｽﾄｸﾞﾛｱｰ	ネルンストグロアー	名詞
ﾈﾙﾝｽﾄｺｳｶ	ネルンスト効果	名詞
ﾈﾙﾝｽﾄﾉﾈﾂﾃｲﾘ	ネルンストの熱定理	名詞
ﾈｰﾙｵﾝﾄﾞ	ネール温度	名詞
ﾈｰﾙｼﾞｮｳﾀｲ	ネール状態	名詞
ﾈｯｾﾝﾌｳｿｸｹｲ	熱線風速計	名詞
ﾈｽﾃｨﾝｸﾞ	ネスティング	名詞
ﾈｰﾀｰﾉﾃｲﾘ	ネーターの定理	名詞
ﾈﾂﾎﾞｳﾁｮｳｹｲ	熱膨張計	名詞
ﾈﾂﾎﾞｳﾁｮｳｹｲｽｳ	熱膨張係数	名詞
ﾈﾂﾎﾞｳﾁｮｳﾘﾂ	熱膨張率	名詞
ﾈﾂﾌﾞﾝｶｲﾎｳ	熱分解法	名詞
ﾈﾂﾀﾞﾝｾｲﾊ	熱弾性波	名詞
ﾈﾂﾀﾞﾝｾｲﾏﾙﾃﾝｻｲﾄ	熱弾性マルテンサイト	名詞
ﾈﾂﾀﾞﾂﾘ	熱脱離	名詞
ﾈﾂﾃﾞﾝﾃﾞﾝﾘｭｳｹｲ	熱電電流計	名詞
ﾈﾂﾃﾞﾝﾄﾞｳﾎｳﾃｲｼｷ	熱伝導方程式	名詞
ﾈﾂﾃﾞﾝﾄﾞｳﾘﾂ	熱伝導率	名詞
ﾈﾂﾃﾞﾝﾍﾝｶﾝｿｼ	熱電変換素子	名詞
ﾈﾂﾃﾞﾝｷｹﾞﾝｼｮｳ	熱電気現象	名詞
ﾈﾂﾃﾞﾝｺｳｶ	熱電効果	名詞
ﾈﾂﾃﾞﾝﾉｳ	熱電能	名詞
ﾈﾂﾃﾞﾝｵﾝﾄﾞｹｲ	熱電温度計	名詞
ﾈﾂﾃﾞﾝﾚｲｷｬｸ	熱電冷却	名詞
ﾈﾂﾃﾞﾝﾘ	熱電離	名詞
ﾈﾂﾃﾞﾝﾘｭｳ	熱電流	名詞
ﾈﾂﾃﾞﾝｼ	熱電子	名詞
ﾈﾂﾃﾞﾝｼﾎｳｼｭｳﾂ	熱電子放出	名詞
ﾈﾂﾃﾞﾝｿｼ	熱電素子	名詞
ﾈﾂﾃﾞﾝﾀﾂ	熱伝達	名詞
ﾈﾂﾃﾞﾝﾂｲ	熱電対	名詞
ﾈﾂﾃﾞﾝﾂｲﾚﾂ	熱電対列	名詞
ﾈﾂﾃﾞﾝﾂｲｼﾝｸｳｹｲ	熱電対真空計	名詞
ﾈﾂﾃﾞﾝｽﾞ	熱電図	名詞
ﾈﾂｴﾈﾙｷﾞｰ	熱エネルギー	名詞
ﾈﾂﾌｨﾗﾒﾝﾄ	熱フィラメント	名詞
ﾈﾂｶﾞｲﾁｭｳｾｲｼ	熱外中性子	名詞
ﾈﾂﾍｲｺｳ	熱平衡	名詞
ﾈﾂﾋﾛｳ	熱疲労	名詞
ﾈﾂｲﾝｷｮｸ	熱陰極	名詞
ﾈﾂｶｶﾞｸﾎｳﾃｲｼｷ	熱化学方程式	名詞
ﾈﾂｶｲﾘ	熱解離	名詞
ﾈﾂｶｸﾌﾞﾝﾚﾂ	熱核分裂	名詞
ﾈﾂｶｸﾊﾝﾉｳ	熱核反応	名詞
ﾈﾂｶｸｻﾝ	熱拡散	名詞
ﾈﾂｶｸｻﾝﾘﾂ	熱拡散率	名詞
ﾈﾂｶﾝｽｳ	熱関数	名詞
ﾈﾂｶｿｾｲ	熱可塑性	名詞
ﾈﾂｶｿｾｲｼﾞｭｼ	熱可塑性樹脂	名詞
ﾈﾂｶｯｾｲｶ	熱活性化	名詞
ﾈﾂｹｲｺｳｾﾝﾘｮｳｹｲ	熱蛍光線量計	名詞
ﾈﾂｷﾃﾞﾝﾘｮｸ	熱起電力	名詞
ﾈﾂｷﾃﾞﾝｱﾂ	熱起電圧	名詞
ﾈﾂｷｶｲｺｳｶ	熱機械効果	名詞
ﾈﾂｷｶﾝ	熱機関	名詞
ﾈﾂｺｳｶｾｲ	熱硬化性	名詞
ﾈﾂｺｳﾘﾂ	熱効率	名詞
ﾈﾂﾉｼｺﾞﾄﾄｳﾘｮｳ	熱の仕事当量	名詞
ﾈﾂｵｳﾘｮｸ	熱応力	名詞
ﾈﾂﾊﾟﾙｽﾎｳ	熱パルス法	名詞
ﾈﾂﾋﾟﾝﾁ	熱ピンチ	名詞
ﾈﾂﾚｲｷ	熱励起	名詞
ﾈﾂﾚﾝｽﾞｺｳｶ	熱レンズ効果	名詞
ﾈﾂﾘｷｶﾞｸﾀﾞｲｲﾁﾎｳｿｸ	熱力学第一法則	名詞
ﾈﾂﾘｷｶﾞｸﾀﾞｲﾆﾎｳｿｸ	熱力学第二法則	名詞
ﾈﾂﾘｷｶﾞｸﾀﾞｲｻﾝﾎｳｿｸ	熱力学第三法則	名詞
ﾀﾞｲｾﾞﾛﾎｳｿｸ	第0法則	名詞
ﾈﾂﾘｷｶﾞｸﾍﾝｽｳ	熱力学変数	名詞
ﾈﾂﾘｷｶﾞｸｶﾝｽｳ	熱力学関数	名詞
ﾀﾞｲｲﾁﾎｳｿｸ	第一法則	名詞
ﾀﾞｲﾆﾎｳｿｸ	第二法則	名詞
ﾀﾞｲｻﾝﾎｳｿｸ	第三法則	名詞
ﾈﾂﾘｷｶﾞｸｵﾝﾄﾞ	熱力学温度	名詞
ﾈﾂﾘｷｶﾞｸﾎﾟﾃﾝｼｬﾙ	熱力学ポテンシャル	名詞
ﾈﾂﾘｷｶﾞｸﾃｷｱﾝﾃｲｾｲ	熱力学的安定性	名詞
ﾈﾂﾘｷｶﾞｸﾃｷｵﾓﾐ	熱力学的重み	名詞
ﾈﾂﾁﾞｷｶﾞｸﾃｷｵﾝﾄﾞ	熱力学的温度	名詞
ﾈﾂﾘｷｶﾞｸﾄｸｾｲｶﾝｽｳ	熱力学特性関数	名詞
ﾈﾂﾙﾐﾈｾﾝｽ	熱ルミネセンス	名詞
ﾈﾂﾘｮｳﾎｿﾞﾝｿｸ	熱量保存則	名詞
ﾈﾂﾘｮｳﾎｿﾞﾝﾉﾎｳｿｸ	熱量保存の法則	名詞
ﾈﾂﾘｮｳｹｲ	熱量計	名詞
ﾈﾂﾘｮｳｿｸﾃｲ	熱量測定	名詞
ﾈﾂﾘｭｳｼﾞｷｺｳｶ	熱流磁気効果	名詞
ﾈﾂｻﾝﾏﾝｻﾝﾗﾝ	熱散漫散乱	名詞
ﾈﾂｾﾝｲ	熱遷移	名詞
ﾈﾂｾｯﾃﾝ	熱接点	名詞
ﾈﾂｼﾝﾄﾞｳ	熱振動	名詞
ﾈﾂｿｸﾄﾞ	熱速度	名詞
ﾈﾂｿﾝｼﾂ	熱損失	名詞
ﾈﾂｿｾｲ	熱塑性	名詞
ﾈﾂｽﾊﾟｲｸ	熱スパイク	名詞
ﾈﾂｼｮｳｹﾞｷ	熱衝撃	名詞
ﾈﾂﾃｲｺｳ	熱抵抗	名詞
ﾈﾂﾃｷﾃｷｵｳｹｲｽｳ	熱的適応係数	名詞
ﾈﾂﾃﾝﾋﾞﾝ	熱てんびん	名詞
ﾈﾂﾁｭｳｾｲｼ	熱中性子	名詞
ﾈﾂﾁｭｳｾｲｼｶ	熱中性子化	名詞
ﾈﾂﾁｭｳｾｲｼﾛ	熱中性子炉	名詞
ﾈﾂｳﾝﾄﾞｳ	熱運動	名詞
ﾈﾂｳﾝﾄﾞｳｿｸﾄﾞ	熱運動速度	名詞
ﾈﾂﾖｸ	熱浴	名詞
ﾈﾂｻﾞﾝﾘｭｳｼﾞｶ	熱残留磁化	名詞
ﾈﾂｻﾞﾂｵﾝ	熱雑音	名詞
ﾈﾂｼﾞｭｳﾘｮｳﾌﾞﾝｾｷ	熱重量分析	名詞
ﾈｼﾞﾚﾊﾞｶﾘ	ねじればかり	名詞
ﾈｼﾞﾚｺﾞｳｾｲ	ねじれ剛性	名詞
ﾈｼﾞﾚﾌﾘｺ	ねじれ振り子	名詞
ﾈｼﾞﾚﾘﾂ	ねじれ率	名詞
ﾈｼﾞﾚﾘｭｳｶｲ	ねじれ粒界	名詞
ﾈｼﾞﾚｼﾝﾄﾞｳ	ねじれ振動	名詞
ﾈｼﾞﾘｺﾞｳｾｲ	ねじり剛性	名詞
ﾈｼﾞﾘｼﾝﾄﾞｳ	ねじり振動	名詞
ﾆﾊﾞｲｾｲﾄﾞ	二倍精度	名詞
ﾆﾃﾞﾝｼｾｲｻｲｹﾂｺﾞｳ	二電子性再結合	名詞
ﾆｴｷﾏﾉﾒｰﾀｰ	二液マノメーター	名詞
ﾆｹﾞﾝｺﾞｳｷﾝ	二元合金	名詞
ﾆｹﾞﾝｼﾌﾞﾝｼ	二原子分子	名詞
ﾆｹﾞﾝｼｷﾀｲ	二原子気体	名詞
ﾆｺﾞﾘﾄﾞ	濁り度	名詞
ﾆｺﾞﾘﾄﾞｹｲ	濁り度計	名詞
ﾆﾊｷﾝｼﾞ	二波近似	名詞
ﾆﾎﾝｺｳｷﾞｮｳｷｶｸ	日本工業規格	名詞
ﾆﾎﾝﾂﾞﾘ	二本づり	名詞
ﾆﾎﾝｽﾞﾘ	二本づり	名詞
ﾆｺｳﾌﾞﾝﾌﾟ	二項分布	名詞
ﾆｺｳﾛｶﾝｼｮｳ	二光路干渉	名詞
ﾆｺﾙﾌﾟﾘｽﾞﾑ	ニコルプリズム	名詞
ﾆｺﾙｽｾﾝｽﾞ	ニコルス線図	名詞
ﾆｺｳｼｷｭｳｼｭｳ	二光子吸収	名詞
ﾆｺｳｼｾﾝｲ	二光子遷移	名詞
ﾆｺｳｿｸｶﾝｼｮｳ	二光束干渉	名詞
ﾆｷｮｸｶﾝ	二極管	名詞
ﾆﾙｿﾝﾓｹｲ	ニルソン模型	名詞
ﾆﾘｮｳﾀｲ	二量体	名詞
ﾆﾘｭｳｼｿｳｶﾝ	二粒子相関	名詞
ﾆﾘｭｳﾀｲﾌｱﾝﾃｲｾｲ	二流体不安定性	名詞
ﾆｼﾝｹｲｽｳｶｲﾛ	二進計数回路	名詞
ﾆｼｮｸｵﾝﾄﾞｹｲ	二色温度計	名詞
ﾆｼｮｸｾｲ	二色性	名詞
ﾆﾀｲﾓﾝﾀﾞｲ	二体問題	名詞
ﾆﾀｲﾘｮｸ	二体力	名詞
ﾆﾀｲｼｮｳﾄﾂｷﾝｼﾞ	二体衝突近似	名詞
ﾆﾀｲｼｮｳﾄﾂﾓｹｲ	二体衝突模型	名詞
ﾆﾀﾝｼﾃｲｽｳ	二端子定数	名詞
ﾆﾀﾝｼﾂｲｶｲﾛ	二端子対回路	名詞
ﾆﾁｹﾞﾂｻｲｻ	日月歳差	名詞
ﾆﾁｭｳｼﾝｶｸﾓｹｲ	二中心殻模型	名詞
ﾆﾁｭｳｼﾝｷﾄﾞｳ	二中心軌道	名詞
ﾆﾁｭｳｼﾝｷﾄﾞｳｶﾝｽｳ	二中心軌道関数	名詞
ﾆｼﾞﾃﾞﾝﾘｭｳ	二次電流	名詞
ﾆｼﾞﾃﾞﾝｼ	二次電子	名詞
ﾆｼﾞﾃﾞﾝｼｿﾞｳﾌｸｶﾝ	二次電子増幅管	名詞
ﾆｼﾞｹﾞﾝｹｲ	二次元系	名詞
ﾆｼﾞｹﾞﾝｺｳｼ	二次元格子	名詞
ﾆｼﾞｲｵﾝﾎｳｼｭﾂ	二次イオン放出	名詞
ﾆｼﾞｲｵﾝｼﾂﾘｮｳﾌﾞﾝｾｷ	二次イオン質量分析	名詞
ﾆｼﾞｲｵﾝ	二次イオン	名詞
ﾆｼﾞｶｲﾛ	二次回路	名詞
ﾆｼﾞｹｲｼｷ	二次形式	名詞
ﾆｼﾞｹｯｶﾝ	二次欠陥	名詞
ﾆｼﾞｷｼﾞｭﾝｵﾝﾄﾞ	二次基準温度	名詞
ﾆｼﾞｺｲﾙ	二次コイル	名詞
ﾆｼﾞｺｳｶ	二次効果	名詞
ﾆｼﾞｺｳｿﾞｳ	二次構造	名詞
ﾆｼﾞｸｹｯｼｮｳ	二軸結晶	名詞
ﾆｼﾞｷｮｸﾒﾝ	二次曲面	名詞
ﾆｼﾞｷｮｸｾﾝ	二次曲線	名詞
ﾆｼﾞｷｮｳﾒｲ	二次共鳴	名詞
ﾆｼﾞｵﾝﾄﾞｹｲ	二次温度計	名詞
ﾆｼﾞﾘｭｳｼ	二次粒子	名詞
ﾆｼﾞｻﾝﾗﾝ	にじ散乱	名詞
ﾆｼﾞｿｳﾃﾝｲ	二次相転移	名詞
ﾆｼﾞｼｮｳｽｲ	二次消衰	名詞
ﾆｼﾞｼｭｳｻ	二次収差	名詞
ﾆｼﾞｳﾁｭｳｾﾝ	二次宇宙線	名詞
ﾆｼﾞXｾﾝ	二次X線	名詞
ﾆｼﾞｮｳﾍｲｷﾝｿｸﾄﾞ	二乗平均速度	名詞
ﾆｼﾞｮｳｹﾝﾊﾟ	二乗検波	名詞
ﾆｼﾞｭｳｱﾗｲﾝﾒﾝﾄ	二重アラインメント	名詞
ﾆｼﾞｭｳﾍﾞｰﾀﾎｳｶｲ	二重β崩壊	名詞
ﾆｼﾞｭｳﾍﾞｰﾀﾎｳｶｲ	二重$\beta$崩壊	名詞
ﾆｼﾞｭｳﾍﾞｰﾀﾎｳｶｲ	二重\beta崩壊	名詞
ﾆｼﾞｭｳﾋﾞﾌﾞﾝ	二重微分	名詞
ﾆｼﾞｭｳﾌﾞﾝﾚﾂ	二重分裂	名詞
ﾆｼﾞｭｳｸﾞﾝ	二重群	名詞
ﾆｼﾞｭｳﾍｲｶｸｶｸ	二重閉殻核	名詞
ﾆｼﾞｭｳﾍﾃﾛﾚｰｻﾞｰ	二重ヘテロレーザー	名詞
ﾆｼﾞｭｳﾍﾃﾛｺｳｿﾞｳ	二重ヘテロ構造	名詞
ﾆｼﾞｭｳﾌﾘｺ	二重振り子	名詞
ﾆｼﾞｭｳｹﾂｺﾞｳ	二重結合	名詞
ﾆｼﾞｭｳｺｳ	二重項	名詞
ﾆｼﾞｭｳｺｳｶﾝ	二重交換	名詞
ﾆｼﾞｭｳｺｳｻｽﾍﾞﾘ	二重交差すべり	名詞
ﾆｼﾞｭｳｺｳｼﾞｮｳﾀｲ	二重項状態	名詞
ﾆｼﾞｭｳｷｮｳﾒｲ	二重共鳴	名詞
ﾆｼﾞｭｳｻﾝﾗﾝﾎｳ	二重散乱法	名詞
ﾆｼﾞｭｳｾﾝ	二重線	名詞
ﾆｼﾞｭｳｼｽｳｶﾝｽｳ	二重指数関数	名詞
ｶﾞﾀｺｳｼｷ	型公式	名詞
ﾆｼﾞｭｳｿｳ	二重層	名詞
ﾆｼﾞｭｳｼｭｳｿｸ	二重集束	名詞
ﾆｼﾞｭｳﾜｷﾀﾞｼ	二重湧き出し	名詞
ﾉﾋﾞｹｲ	伸び計	名詞
ﾉｳﾄﾞｳﾊﾞｲｼﾂ	能動媒質	名詞
ﾉｳﾄﾞｳﾌｨﾙﾀｰ	能動フィルター	名詞
ﾉｳﾄﾞｳｶｲﾛ	能動回路	名詞
ﾉｳﾄﾞｹｲ	濃度計	名詞
ﾉｳﾄﾞｳｿｼ	能動素子	名詞
ﾉｳﾄﾞｳﾕｿｳ	能動輸送	名詞
ﾉｺｷﾞﾘﾊ	のこぎり波	名詞
ﾉｰﾏﾙｶﾃｲ	ノーマル過程	名詞
ﾉｰﾏﾙｾｷ	ノーマル積	名詞
ﾉｰﾏﾙｾﾙ	ノーマルセル	名詞
ﾉﾓﾝﾄｳｴｲ	ノモン投影	名詞
ﾉﾙﾑ	ノルム	名詞
ﾉｳｼｮｸｺｳｶ	濃色効果	名詞
ﾉｳｼｭｸｳﾗﾝ	濃縮ウラン	名詞
ﾇｰﾄﾞｹﾞｰｼﾞ	ヌードゲージ	名詞
ﾆｰﾌﾟｶﾀｻ	ヌープ硬さ	名詞
ﾇｯｾﾙﾄｽｳ	ヌッセルト数	名詞
ﾆｭｳﾀﾞｸ	乳濁	名詞
ﾆｭｳﾀﾞｸｴｷ	乳濁液	名詞
ﾆｭｳﾊｸﾄﾞ	乳白度	名詞
ﾆｭｳﾊｸｶﾞﾗｽ	乳白ガラス	名詞
ﾆｭｳｶｼﾞｭｳｺﾞｳ	乳化重合	名詞
ﾆｭｳｺｳ	乳光	名詞
ﾆｭｰﾏﾃｨｯｸｾﾙ	ニューマティックセル	名詞
ﾆｭｰﾝｽﾞｱﾝﾀﾞｰｿﾝ	ニューンズ・アンダーソン	名詞
ﾆｭｳﾘｮｸﾍﾝｾｲｷ	入力変成器	名詞
ﾆｭｳﾘｮｸｲﾝﾋﾟｰﾀﾞﾝｽ	入力インピーダンス	名詞
ﾆｭｳｼｬﾊ	入射波	名詞
ﾆｭｳｼｬｶｸ	入射角	名詞
ﾆｭｳｼｬｷ	入射器	名詞
ﾆｭｳｼｬﾒﾝ	入射面	名詞
ﾆｭｼｬﾘｭｳｼ	入射粒子	名詞
ﾆｭｰﾄﾝ	Newton	人名
ﾆｭｰﾄﾝﾎｳ	ニュートン法	名詞
ﾆｭｰﾄﾝｶﾝ	ニュートン環	名詞
ﾆｭｰﾄﾝﾈﾝｾｲ	ニュートン粘性	名詞
ﾆｭｰﾄﾝﾉﾚｲｷｬｸﾉﾎｳｿｸ	ニュートンの冷却の法則	名詞
ﾆｭｰﾄﾝﾉﾃｲｺｳﾎｳｿｸ	ニュートンの抵抗法則	名詞
ﾆｭｰﾄﾝﾉｳﾝﾄﾞｳﾎｳｿｸ	ニュートンの運動法則	名詞
ﾆｭｰﾄﾝﾎﾟﾃﾝｼｬﾙ	ニュートンポテンシャル	名詞
ﾆｭｰﾄﾝﾗﾌｿﾝﾎｳ	ニュートン・ラフソン法	名詞
ﾆｭｰﾄﾝﾘｷｶﾞｸ	ニュートン力学	名詞
ﾆｭｰﾄﾝﾘｭｳﾄﾞｳ	ニュートン流動	名詞
ﾆｭｰﾄﾝﾘｭｳﾀｲ	ニュートン流体	名詞
ﾆｭｰﾄﾘﾉ	ニュートリノ	名詞
ﾆｭｰﾄﾘﾉｼﾝﾄﾞｳ	ニュートリノ振動	名詞
ﾆｭｰﾄﾘﾉｿﾝｼﾂ	ニュートリノ損失	名詞
ｵﾉｴﾀﾞ	Oの枝	名詞
ｵﾍﾟﾎﾟﾃﾝｼｬﾙ	OPEポテンシャル	名詞
ｵPWﾎｳ	OPW法	名詞
ｵｼﾞｿｸ	OZI則	名詞
ｵｱｿﾞﾝﾏｰﾌｪﾙﾄ	オア・ゾンマーフェルト	人名
ｵｰﾊﾞｰﾊｳｻﾞｰｺｳｶ	オーバーハウザー効果	名詞
ｵｰﾊﾞｯｸｶﾃｲ	オーバック過程	名詞
ｵｰﾋﾞﾄﾛﾝｹﾞｰｼﾞ	オービトロンゲージ	名詞
ｵｰﾋﾞﾄﾛﾝﾎﾟﾝﾌﾟ	オービトロンポンプ	名詞
ｵﾌﾞｻﾞｰﾊﾞﾌﾞﾙ	オブザーバブル	名詞
ｵｲﾗｰ	オイラー	人名
ｵｲﾗｰ	Euler	人名
ｵｲﾗｰｶｸ	オイラー角	名詞
ｵｲﾗｰﾉｺﾏ	オイラーのこま	名詞
ｵｲﾗｰﾉﾚﾝｿﾞｸﾎｳﾃｲｼｷ	オイラーの連続方程式	名詞
ｵｲﾗｰﾉｳﾝﾄﾞｳﾎｳﾃｲｼｷ	オイラーの運動方程式	名詞
ｵｲﾗｰﾗｸﾞﾗﾝｼﾞｭ	オイラー・ラグランジュ	人名
ｵｲﾙﾐｽﾄﾄﾗｯﾌﾟ	オイルミストトラップ	名詞
ｵｵｷﾅﾎﾟｰﾗﾝ	大きなポーラン	名詞
ｵｺﾛｺﾌｺｳｶ	オコロコフ効果	名詞
ｵｸﾚﾊｶｲ	遅れ破壊	名詞
ｵﾒｶﾞﾄﾛﾝ	オメガトロン	名詞
ｵｳﾒﾝｶｲｾﾂｺｳｼ	凹面回折格子	名詞
ｵｳﾒﾝｺｳｼ	凹面格子	名詞
ｵﾓｲﾌｪﾙﾐﾘｭｳｼ	重いフェルミ粒子	名詞
ｵﾓｲﾚﾌﾟﾄﾝ	重いレプトン	名詞
ｵﾓｲｼﾞｭﾝﾘｭｳｼ	重い準粒子	名詞
ｵﾓﾐｶﾝｽｳ	重み関数	名詞
ｵﾓﾐﾂｷﾍｲｷﾝ	重みつき平均	名詞
ｵﾓﾐﾂｷｻﾞﾝｻﾎｳ	重みつき残差法	名詞
ｵｰﾑｶﾈﾂ	オーム加熱	名詞
ｵｰﾑｹｲ	オーム計	名詞
ｵｰﾑﾉﾎｳｿｸ	オームの法則	名詞
ｵｰﾑｾｯｼｮｸ	オーム接触	名詞
ｵｰﾑｾｲｾｯｼｮｸ	オーム性接触	名詞
ｵｰﾑﾃｲｺｳ	オーム抵抗	名詞
ｵﾝｱﾂ	音圧	名詞
ｵﾝｱﾂｺｳｾｲ	音圧校正	名詞
ｵﾝｱﾂｺｳｾｲﾎｳ	音圧校正法	名詞
ｵﾝﾊﾞ	音場	名詞
ｵﾝﾊﾞｺｳｾｲ	音場校正	名詞
ｵﾝﾊﾞｺｳｾｲﾎｳ	音場校正法	名詞
ｵﾝﾄﾞﾌﾞﾝﾌﾟ	温度分布	名詞
ｵﾝﾄﾞﾌﾞﾝｻﾝ	温度分散	名詞
ｵﾝﾄﾞｸﾞﾘｰﾝｶﾝｽｳ	温度グリーン関数	名詞
ｵﾝﾄﾞﾊ	温度波	名詞
ｵﾝﾄﾞｹｲｽｳ	温度係数	名詞
ｵﾝﾄﾞｺｳﾊﾞｲ	温度勾配	名詞
ｵﾝﾄﾞﾒﾓﾘ	温度目盛	名詞
ｵﾝﾄﾞｾｲｹﾞﾝﾃﾞﾝﾘｭｳ	温度制限電流	名詞
ｵﾝﾄﾞｾｲｷﾞｮ	温度制御	名詞
ｵﾝﾄﾞﾃｲﾃﾝ	温度定点	名詞
ｵﾝﾄﾞｼﾞｬﾝﾌﾟﾎｳ	温度ジャンプ法	名詞
ｵﾝｷｮｳｱﾚｲ	音響アレイ	名詞
ｵﾝｷｮｳﾃﾞﾝｷﾃﾞﾝﾘｭｳ	音響電気電流	名詞
ｵﾝｷｮｳﾃﾞﾝｷｿﾞｳﾌｸ	音響電気増幅	名詞
ｵﾝｷｮｳﾃﾞﾝｼｽﾋﾟﾝ	音響電子スピン	名詞
ｵﾝｷｮｳﾌｨﾙﾀｰ	音響フィルター	名詞
ｵﾝｷｮｳﾍﾝｶﾝｷ	音響変換器	名詞
ｵﾝｷｮｳﾍﾝｾｲｷ	音響変成器	名詞
ｵﾝｷｮｳﾎﾛｸﾞﾗﾌｨｰ	音響ホログラフィー	名詞
ｵﾝｷｮｳﾌｸｸｯｾﾂ	音響複屈折	名詞
ｵﾝｷｮｳｲﾅｰﾀﾝｽ	音響イナータンス	名詞
ｵﾝｷｮｳｲﾝﾋﾟｰﾀﾞﾝｽ	音響インピーダンス	名詞
ｵﾝｷｮｳｶﾝ	音響管	名詞
ｵﾝｷｮｳｶﾝｼｮｳｹｲ	音響干渉計	名詞
ｵﾝｷｮｳｶﾌﾟﾗｰ	音響カプラー	名詞
ｵﾝｷｮｳｷﾃﾞﾝﾘｮｸ	音響起電力	名詞
ｵﾝｷｮｳｺｳｶﾞｸｺｳｶ	音響光学効果	名詞
ｵﾝｷｮｳｺｳｶﾞｸｿｼ	音響光学素子	名詞
ｵﾝｷｮｳｺｳｶ	音響効果	名詞
ｵﾝｷｮｳｺﾝﾌﾟﾗｲｱﾝｽ	音響コンプライアンス	名詞
ｵﾝｷｮｳﾓｰﾄﾞ	音響モード	名詞
ｵﾝｷｮｳｵｰﾑ	音響オーム	名詞
ｵﾝｷｮｳﾊﾟﾜｰﾚﾍﾞﾙ	音響パワーレベル	名詞
ｵﾝｷｮｳﾘｱｸﾀﾝｽ	音響リアクタンス	名詞
ｵﾝｷｮｳｿｸﾃｲ	音響測定	名詞
ｵﾝｷｮｳｽﾍﾟｸﾄﾙ	音響スペクトル	名詞
ｵﾝｷｮｳﾃｲｺｳ	音響抵抗	名詞
ｵﾝｷｮｳｼﾞｷﾃﾞﾝｷｺｳｶ	音響磁気電気効果	名詞
ｵﾝﾊﾟﾌﾞｯｾｲ	音波物性	名詞
ｵﾝﾊﾟｹﾞﾝｽｲ	音波減衰	名詞
ｵﾝﾊﾟﾊﾝｼｬ	音波反射	名詞
ｵﾝﾊﾟﾎｳｼｬ	音波放射	名詞
ｵﾝﾊﾟｶｲｾﾂ	音波回折	名詞
ｵﾝﾊﾟｶｸｻﾝ	音波拡散	名詞
ｵﾝﾊﾟｶﾝｼｮｳ	音波干渉	名詞
ｵﾝﾊﾟｸｯｾﾂ	音波屈折	名詞
ｵﾝﾊﾟｷｭｳｼｭｳ	音波吸収	名詞
ｵﾝﾊﾟｻﾝﾗﾝ	音波散乱	名詞
ｵﾝﾗｲﾝﾄﾞｳｲﾀｲﾌﾞﾝﾘｷ	オンライン同位体分離器	名詞
ｵﾝﾗｲﾝｾｲｷﾞｮ	オンライン制御	名詞
ｵﾝｻ	おんさ	名詞
ｵﾝｻｰｶﾞｰﾉｿｳﾊﾝﾃｲﾘ	オンサーガーの相反定理	名詞
ｵﾝｾｲﾌﾞﾝｾｷ	音声分析	名詞
ｵﾝｾｲｺﾞｳｾｲ	音声合成	名詞
ｵﾝｾｲﾆﾝｼｷ	音声認識	名詞
ｵﾝｾｲｼｮﾘ	音声処理	名詞
ｵﾝｾｲｼｭｳﾊ	音声周波	名詞
ｵﾝｾｲｼｭｳﾊｽｳ	音声周波数	名詞
ｵﾝｾﾝ	音線	名詞
ｵﾝｾﾂﾒｲﾘｮｳﾄﾞ	音節明りょう度	名詞
ｵﾝｼﾂｺｳｶ	温室効果	名詞
ｵﾝｿﾞｳﾃｲｲ	音像定位	名詞
ｵﾌﾟﾄｶﾞﾙﾊﾞﾆｯｸｺｳｶ	オプトガルバニック効果	名詞
ｵﾗﾌｧﾃｨｰﾉﾃｲﾘ	オラファティーの定理	名詞
ｵﾘﾌｨｽ	オリフィス	名詞
ｵﾘﾌｨｽﾘｭｳﾘｮｳｹｲ	オリフィス流量計	名詞
ｵﾘｺﾞﾏｰ	オリゴマー	名詞
ｵﾘﾀﾀﾐｺｳｿﾞｳ	折りたたみ構造	名詞
ｺﾘﾀﾀﾐｸｻﾘｺｳｿﾞｳ	折りたたみ鎖構造	名詞
ｵﾙﾝｼｭﾀｲﾝｾﾞﾙﾆｹﾘﾛﾝ	オルンシュタイン・ゼルニケ理論	名詞
ｵﾙﾄ	オルト	名詞
ｵﾙﾄﾍﾘｳﾑ	オルトヘリウム	名詞
ｵﾙﾄﾊﾟﾗﾍﾝｶﾝ	オルト-パラ変換	名詞
ｵﾙﾄｽｲｿ	オルト水素	名詞
ｵｳﾘｮｸﾊ	応力波	名詞
ｵｳﾘｮｸﾋｽﾞﾐｷｮｸｾﾝ	応力-ひずみ曲線	名詞
ｵｳﾘｮｸﾌｼｮｸﾜﾚ	応力腐食割れ	名詞
ｵｳﾘｮｸｶｸﾀﾞｲｹｲｽｳ	応力拡大係数	名詞
ｵｳﾘｮｸｶﾝｽｳ	応力関数	名詞
ｵｳﾘｮｸｶﾝﾜ	応力緩和	名詞
ｵｳﾘｮｸｷﾚﾂ	応力亀裂	名詞
ｵｳﾘｮｸｼｭｳﾁｭｳ	応力集中	名詞
ｵｳﾘｮｸｼｭｳﾁｭｳｹｲｽｳ	応力集中係数	名詞
ｵｳﾘｮｸﾃﾝｿﾙ	応力テンソル	名詞
ｵｰｾﾝ	オーセン	人名
ｵｰｾﾝ	Oseen	人名
ｵｰｾﾝｷﾝｼﾞ	オーセン近似	名詞
ｵｰｾﾝﾉﾎｳﾃｲｼｷ	オーセンの方程式	名詞
ｵｰｾﾝﾉﾃﾝｿﾙ	オーセンのテンソル	名詞
ｵｼﾀﾞｼｾｲｹｲ	押出成形	名詞
ｵｼﾉｹｱﾂｻ	おしのけ厚さ	名詞
ｵｼﾘｽﾀｰ	オシリスター	名詞
ｵｿｲﾋﾞｰﾑﾄﾘﾀﾞｼ	遅いビーム取りだし	名詞
ｵｰｽﾃﾅｲﾄ	オーステナイト	名詞
ｵｽﾄﾜﾙﾄﾞﾈﾝｾｲｹｲ	オストワルド粘性計	名詞
ｵｳﾄｳｶﾝｹｲ	応答関係	名詞
ｵｳﾄｳｶﾝｽｳ	応答関数	名詞
ｵｰﾄｺﾘﾒｰｼｮﾝ	オートコリメーション	名詞
ｵｰﾄｺﾘﾒｰﾀｰ	オートコリメーター	名詞
ｵｰﾄﾏﾄﾝ	オートマトン	名詞
ｵﾄﾉｵｵｷｻ	音の大きさ	名詞
ｵﾄﾉｵｵｷｻﾉﾚﾍﾞﾙ	音の大きさのレベル	名詞
ｵﾄﾉﾀｶｻ	音の高さ	名詞
ｵｰﾄﾗｼﾞｵｸﾞﾗﾌｨｰ	オートラジオグラフィー	名詞
ｵﾄﾙﾐﾈｾﾝｽ	音ルミネセンス	名詞
ｵｯﾄｰｻｲｸﾙ	オットーサイクル	名詞
ｵﾔﾌﾞｯｼﾂ	親物質	名詞
ｵﾔｶｸ	親核	名詞
ｵﾔﾋﾟｰｸ	親ピーク	名詞
ｵｳﾖｳﾌﾞﾂﾘｶﾞｸ	応用物理学	名詞
ｵｳﾖｳﾘｷｶﾞｸ	応用力学	名詞
ｵｿﾞﾅｲｻﾞｰﾎｳﾃﾞﾝ	オゾナイザー放電	名詞
ｵｰｼﾞｪ	オージェ	人名
ｵｰｼﾞｪ	Auger	人名
ｵｰｼﾞｪﾃﾞﾝｼ	オージェ電子	名詞
ｵｰｼﾞｪﾃﾞﾝｼﾌﾞﾝｺｳﾎｳ	オージェ電子分光法	名詞
ｵｰｼﾞｪｺｳｶ	オージェ効果	名詞
ﾊﾟｲﾃﾞﾝｼ	π電子	名詞
ﾊﾟｲﾃﾞﾝｼ	$\pi$電子	名詞
ﾊﾟｲﾃﾞﾝｼ	\pi電子	名詞
ﾊﾟｲｹﾂｺﾞｳ	π結合	名詞
ﾊﾟｲｹﾂｺﾞｳ	$\pi$結合	名詞
ﾊﾟｲｹﾂｺﾞｳ	\pi結合	名詞
ﾊﾟｲｷﾄﾞｳ	π軌道	名詞
ﾊﾟｲｷﾄﾞｳ	$\pi$軌道	名詞
ﾊﾟｲｷﾄﾞｳ	\pi軌道	名詞
ﾊﾟｲｷﾄﾞｳｶﾝｽｳ	π軌道関数	名詞
ﾊﾟｲｷﾄﾞｳｶﾝｽｳ	$\pi$軌道関数	名詞
ﾊﾟｲｷﾄﾞｳｶﾝｽｳ	\pi軌道関数	名詞
ﾊﾟｲﾃｲﾘ	π定理	名詞
ﾊﾟｲﾃｲﾘ	$\pi$定理	名詞
ﾊﾟｲﾃｲﾘ	\pi定理	名詞
ﾊﾟｲﾁｭｳｶﾝｼ	π中間子	名詞
ﾊﾟｲﾁｭｳｶﾝｼ	$\pi$中間子	名詞
ﾊﾟｲﾁｭｳｶﾝｼ	\pi中間子	名詞
ﾊﾟｲﾁｭｳｶﾝｼｹﾞﾝｼ	π中間子原子	名詞
ﾊﾟｲﾁｭｳｶﾝｼｹﾞﾝｼ	$\pi$中間子原子	名詞
ﾊﾟｲﾁｭｳｶﾝｼｹﾞﾝｼ	\pi中間子原子	名詞
ﾊﾟｲﾁｭｳｶﾝｼｷﾞｮｳｼｭｸ	π中間子凝縮	名詞
ﾊﾟｲﾁｭｳｶﾝｼｷﾞｮｳｼｭｸ	$\pi$中間子凝縮	名詞
ﾊﾟｲﾁｭｳｶﾝｼｷﾞｮｳｼｭｸ	\pi中間子凝縮	名詞
1ﾊﾟｲﾁｭｳｶﾝｼ	1π中間子	名詞
1ﾊﾟｲﾁｭｳｶﾝｼ	1$\pi$中間子	名詞
1ﾊﾟｲﾁｭｳｶﾝｼ	1\pi中間子	名詞
ｲﾁﾊﾟｲﾁｭｳｶﾝｼ	1π中間子	名詞
ｲﾁﾊﾟｲﾁｭｳｶﾝｼ	1$\pi$中間子	名詞
ｲﾁﾊﾟｲﾁｭｳｶﾝｼ	1\pi中間子	名詞
Pｶﾞﾀﾊﾝﾄﾞｳﾀｲ	p型半導体	名詞
PH	pH	名詞
Pﾊ	p波	名詞
ﾋﾟﾝﾀﾞｲｵｰﾄﾞ	pinダイオード	名詞
ﾋﾟﾝｹﾂｺﾞｳ	pin結合	名詞
Pｷﾄﾞｳ	p軌道	名詞
Pｷﾄﾞｳｶﾝｽｳ	p軌道関数	名詞
Pﾉｴﾀﾞ	Pの枝	名詞
PﾝPｾﾂｺﾞｳ	pnp接合	名詞
Pﾝｾﾂｺﾞｳ	pn接合	名詞
PQｾﾝｽﾞ	p-Q線図	名詞
PTｷｮｸｾﾝ	p-T曲線	名詞
PVｷｮｸｾﾝ	p-V曲線	名詞
ﾊﾟﾃﾞﾃﾝｶｲ	パデ展開	名詞
ﾊﾟｲｴﾙｽ	パイエルス	人名
ﾊﾟｲｴﾙｽ	Peierls	人名
ﾊﾟｲｴﾙｽﾉﾘｮｳｼｶﾎｳ	パイエルスの量子化法	名詞
ﾊﾟｲｴﾙｽﾎﾟﾃﾝｼｬﾙ	パイエルスポテンシャル	名詞
ﾊﾟｲｴﾙｽﾘｮｸ	パイエルス力	名詞
ﾊﾟｲｴﾙｽﾃﾝｲ	パイエルス転移	名詞
ﾊﾟｲｵﾆｾﾞｰｼｮﾝ	パイオニゼーション	名詞
ﾊﾟｲﾌﾟｶｸｻﾝ	パイプ拡散	名詞
ﾊﾟｲﾛﾃﾞﾝｷ	パイロ電気	名詞
ﾊﾟｲﾙｵﾌﾞﾌﾟﾚｰﾂ	パイルオブプレーツ	名詞
ﾊﾟｰｺﾚｰｼｮﾝ	パーコレーション	名詞
ﾊﾟｰﾏﾛｲ	パーマロイ	名詞
ﾊﾟｰﾐｱﾝｽ	パーミアンス	名詞
ﾊﾟﾉﾌｽｷｰﾋ	パノフスキー比	名詞
ﾊﾟﾗﾍﾘｳﾑ	パラヘリウム	名詞
ﾊﾟﾗｹｯｼｮｳ	パラ結晶	名詞
ﾊﾟﾗﾏｸﾞﾉﾝ	パラマグノン	名詞
ﾊﾟﾗﾒｰﾀｰﾚｲｼﾝ	パラメーター励振	名詞
ﾊﾟﾗﾒﾄﾘｯｸ	パラメトリック	名詞
ﾊﾟﾗﾒﾄﾘｯｸｱﾚｲ	パラメトリックアレイ	名詞
ﾊﾟﾗﾒﾄﾘｯｸﾀﾞｲｵｰﾄﾞ	パラメトリックダイオード	名詞
ﾊﾟﾗﾒﾄﾘｯｸﾚｲｷ	パラメトリック励起	名詞
ﾊﾟﾗﾒﾄﾘｯｸｿﾞｳﾌｸ	パラメトリック増幅	名詞
ﾊﾟﾗﾒﾄﾛﾝ	パラメトロン	名詞
ﾊﾟﾗｽｲｿ	パラ水素	名詞
ﾊﾟﾗﾄｳｹｲ	パラ統計	名詞
ﾊﾟﾘﾃｨ	パリティ	名詞
ﾊﾟﾘﾃｨﾎｿﾞﾝｿｸ	パリティ保存則	名詞
ﾊﾟﾘﾃｨﾉﾔﾌﾞﾚ	パリティのやぶれ	名詞
ﾊﾟﾙｹｸﾞﾗﾌ	パルケグラフ	名詞
ﾊﾟﾙｻｰ	パルサー	名詞
ﾊﾟﾙｽﾋﾞｰﾑ	パルスビーム	名詞
ﾊﾟﾙｽﾊﾊﾞ	パルス幅	名詞
ﾊﾟﾙｽﾊｺｳ	パルス波高	名詞
ﾊﾟﾙｽﾊｺｳﾌﾞﾝｾｷｷ	パルス波高分析器	名詞
ﾊﾟﾙｽﾊｯｾｲｷ	パルス発生器	名詞
ﾊﾟﾙｽﾍﾝﾁｮｳ	パルス変調	名詞
ﾊﾟﾙｽﾎｳﾃﾞﾝ	パルス放電	名詞
ﾊﾟﾙｽﾓｰﾀｰ	パルスモーター	名詞
ﾊﾟﾙｽﾚｰｻﾞｰ	パルスレーザー	名詞
ﾊﾟﾙｽﾄﾗﾝｽ	パルストランス	名詞
ﾊﾟﾙｽﾁｭｳｾｲｼｹﾞﾝ	パルス中性子源	名詞
ﾊﾟﾙｽｿﾞｳﾌｸｷ	パルス増幅器	名詞
ﾊﾟｰｾｸ	パーセク	名詞
ﾊﾟｰｾﾌﾟﾄﾛﾝ	パーセプトロン	名詞
ﾊﾟｯｼｪﾝ	パッシェン	人名
ﾊﾟｯｼｪﾝ	Paschen	人名
ﾊﾟｯｼｪﾝﾊﾞｯｸｺｳｶ	パッシェン・バック効果	名詞
ﾊﾟｯｼｪﾝｹｲﾚﾂ	パッシェン系列	名詞
ﾊﾟｯｼｪﾝﾉﾎｳｿｸ	パッシェンの法則	名詞
ﾊﾟｯｼｪﾝﾙﾝｹﾞ	パッシェン・ルンゲ	人名
ﾏｳﾝﾃｨﾝｸﾞ	マウンティング	名詞
ﾊﾟｽｶﾙﾉｹﾞﾝﾘ	パスカルの原理	名詞
ﾊﾟｽｶﾙﾉﾎｳｿｸ	パスカルの法則	名詞
ﾊﾟﾀｰﾝｹｲｽｳ	パターン係数	名詞
ﾊﾟﾀｰﾝﾆﾝｼｷ	パターン認識	名詞
ﾊﾟﾀｰｿﾝｶﾝｽｳ	パターソン関数	名詞
ﾊﾟｰﾄﾝﾓｹｲ	パートン模型	名詞
ﾊﾟｳﾘ	パウリ	人名
ﾊﾟｳﾘ	Pauli	人名
ﾊﾟｳﾘｷﾞｮｳﾚﾂ	パウリ行列	名詞
ﾊﾟｳﾘｷﾝｼﾞ	パウリ近似	名詞
ﾊﾟｳﾘﾉｹﾞﾝﾘ	パウリの原理	名詞
ﾊﾟｳﾘﾉﾊｲﾀﾘﾂ	パウリの排他律	名詞
ﾊﾟｳﾘﾉﾎｳﾃｲｼｷ	パウリの方程式	名詞
ﾊﾟｳﾘﾉｷﾝｾｲﾘﾂ	パウリの禁制律	名詞
ｽﾋﾟﾝｼﾞｮｳｼﾞｾｲ	スピン常磁性	名詞
ﾊﾟｳﾘﾙﾊﾞﾝｽｷｰﾍﾞｸﾄﾙ	パウリ・ルバンスキーベクトル	名詞
ﾊﾟｳﾘｽﾋﾟﾉﾙ	パウリスピノル	名詞
ﾊﾟﾜｰﾚﾍﾞﾙ	パワーレベル	名詞
ﾊﾟﾜｰｽﾍﾟｸﾄﾙ	パワースペクトル	名詞
ﾍﾟｱﾚﾝﾃｰｼﾞｹｲｽｳ	ペアレンテージ係数	名詞
ﾍﾟｱﾘﾝｸﾞｺｳｶ	ペアリング効果	名詞
ﾍﾟｸﾚｽｳ	ペクレ数	名詞
ﾍﾟﾝﾃﾞﾙｺｳｶ	ペンデル効果	名詞
ﾍﾟﾝﾃﾞﾙｼﾞﾏ	ペンデルじま	名詞
ﾍﾟﾆﾝｸﾞ	ペニング	人名
ﾍﾟﾆﾝｸﾞ	Penning	人名
ﾍﾟﾆﾝｸﾞﾃﾞﾝﾘ	ペニング電離	名詞
ﾍﾟﾆﾝｸﾞｹﾞｰｼﾞ	ペニングゲージ	名詞
ﾍﾟﾆﾝｸﾞﾎｳﾃﾞﾝ	ペニング放電	名詞
ﾍﾟﾆﾝｸﾞｺｳｶ	ペニング効果	名詞
ﾍﾟﾝﾛｰｽﾞｽﾞｹｲ	ペンローズ図形	名詞
ﾍﾟﾝﾀﾝｺｳｶ	ペンタン効果	名詞
ﾍﾟﾗﾝﾌﾞﾛｶﾌﾟﾘｽﾞﾑ	ペラン・ブロカプリズム	名詞
ﾍﾟﾘﾌｪﾗﾙﾊﾝﾉｳ	ペリフェラル反応	名詞
ﾍﾟﾛﾌｽｶｲﾄｶﾞﾀｺｳｿﾞｳ	ペロフスカイト型構造	名詞
ﾍﾟﾙﾃｨｴｺｳｶ	ペルティエ効果	名詞
ﾍﾟﾙﾁｪｺｳｶ	ペルティエ効果	名詞
ﾍﾟｽﾄﾌｶｳﾝﾀｰ	ペストフカウンター	名詞
ﾍﾟｯﾁﾉｶﾝｹｲ	ペッチの関係	名詞
ﾋﾟｴｿﾞﾋｶﾘﾊﾝｼｬﾘﾂ	ピエゾ光反射率	名詞
ﾋﾟｴｿﾞﾎﾟｰﾗﾛﾝ	ピエゾポーラロン	名詞
ﾋﾟｴｿﾞﾃｲｺｳ	ピエゾ抵抗	名詞
ﾋﾟｴｿﾞﾃｲｺｳｿｼ	ピエゾ抵抗素子	名詞
ﾋﾟｴｿﾞｼﾞｷｺｳｶﾞｸｺｳｶ	ピエゾ磁気光学効果	名詞
ﾋﾟｴｿﾞｼﾞｷｺｳｶ	ピエゾ磁気効果	名詞
ﾋﾟｰﾁｹｰﾗｰﾘｮｸ	ピーチ・ケーラー力	名詞
ﾋﾟｯｸｱｯﾌﾟﾊﾝﾉｳ	ピックアップ反応	名詞
ﾋﾟｺﾋﾞｮｳﾋｶﾘﾊﾟﾙｽ	ピコ秒光パルス	名詞
ﾋﾟﾝｸﾉｲｽﾞ	ピンクノイズ	名詞
ﾋﾟﾝﾁﾄｸｲｾｲ	ピンチ特異性	名詞
ﾋﾟﾊﾟｰﾄﾞﾎｳﾃｲｼｷ	ピパード方程式	名詞
ﾋﾟﾗﾆｼﾝｸｳｹｲ	ピラニ真空計	名詞
ﾋﾟｽﾄﾝｵﾝｹﾞﾝ	ピストン音源	名詞
ﾋﾟﾄｰｶﾝ	ピトー管	名詞
ﾎﾟｱﾝｶﾚ	ポアンカレ	人名
ﾎﾟｱﾝｶﾚ	Poincare	人名
ﾎﾟｱﾝｶﾚ	Poincar\"{e}	人名
ﾎﾟｱﾝｶﾚｸﾞﾝ	ポアンカレ群	名詞
ﾎﾟｱﾝｶﾚｷｭｳ	ポアンカレ球	名詞
ﾎﾟｱﾝｶﾚｻｲｸﾙ	ポアンカレサイクル	名詞
ﾎﾟｱﾝｿｰﾉﾃｲﾘ	ポアンソーの定理	名詞
ﾎﾟｱｿﾝ	ポアソン	人名
ﾎﾟｱｿﾝ	Poisson	人名
ﾎﾟｱｿﾝﾌﾞﾝﾌﾟ	ポアソン分布	名詞
ﾎﾟｱｿﾝﾋ	ポアソン比	名詞
ﾎﾟｱｿﾝﾎｳﾃｲｼｷ	ポアソン方程式	名詞
ﾎﾟｱｿﾝｶｯｺ	ポアソン括弧	名詞
ﾎﾟｱｿﾝﾉﾎｳｿｸ	ポアソンの法則	名詞
ﾎﾟｱｽﾞ	ポアズ	名詞
ﾎﾟｱｽﾞｲﾕﾉﾎｳｿｸ	ポアズイユの法則	名詞
ﾎﾟｱｽﾞｲﾕﾉﾅｶﾞﾚ	ポアズイユの流れ	名詞
ﾎﾟｲﾝﾃｨﾝｸﾞﾍﾞｸﾄﾙ	ポインティングベクトル	名詞
ﾎﾟｯｹﾙｽｺｳｶ	ポッケルス効果	名詞
ﾎﾟﾒﾗﾝﾁｭｸｺｳｶ	ポメランチュク効果	名詞
ﾎﾟﾒﾗﾝﾁｭｸﾚｲｷｬｸ	ポメランチュク冷却	名詞
ﾎﾟﾒﾛﾝ	ポメロン	名詞
ﾎﾟﾝﾋﾟﾝｸﾞ	ポンピング	名詞
ﾎﾟﾗﾘﾄﾝ	ポラリトン	名詞
ﾎﾟｰﾗﾛｸﾞﾗﾌｨｰ	ポーラログラフィー	名詞
ﾎﾟｰﾗﾛﾝ	ポーラロン	名詞
ﾎﾟﾘｺﾞﾝｶ	ポリゴン化	名詞
ﾎﾟﾘｸﾛﾒｰﾀｰ	ポリクロメーター	名詞
ﾎﾟﾘﾏｰｱﾛｲ	ポリマーアロイ	名詞
ﾎﾟｰﾘﾝｸﾞﾉｹﾞﾝﾘ	ポーリングの原理	名詞
ﾎﾟﾘﾀｲﾌﾟ	ポリタイプ	名詞
ﾎﾟﾛｲﾀﾞﾙｼﾞﾊﾞ	ポロイダル磁場	名詞
ﾎﾟｰﾙｾﾞﾛﾎｼｮｳ	ポールゼロ補償	名詞
ﾎﾟｽﾄﾆｭｰﾄﾝｷﾝｼﾞ	ポストニュートン近似	名詞
ﾎﾟｰﾀﾌﾞﾙｾﾝｹﾞﾝ	ポータブル線源	名詞
ﾎﾟﾃﾝｼｬﾙｴﾈﾙｷﾞｰ	ポテンシャルエネルギー	名詞
ﾎﾟﾃﾝｼｬﾙﾒﾝ	ポテンシャル面	名詞
ﾎﾟﾃﾝｼｬﾙﾘｭｳ	ポテンシャル流	名詞
ﾎﾟﾃﾝｼｬﾙｻﾝﾗﾝ	ポテンシャル散乱	名詞
ﾎﾟﾃﾝｼｬﾙｼｮｳﾍｷ	ポテンシャル障壁	名詞
ﾎﾟｯﾄｺｱ	ポットコア	名詞
ﾎﾟｼﾞﾄﾛﾆｳﾑ	ポジトロニウム	名詞
ﾌﾟﾝﾄｹｲﾚﾂ	プント系列	名詞
ﾌﾟﾀﾈﾀﾘｰﾊ	プラネタリー波	名詞
ﾌﾟﾗﾆﾒｰﾀｰ	プラニメーター	名詞
ﾌﾟﾗﾝｸﾉﾎｳｼｬｺｳｼｷ	プランクの放射公式	名詞
ﾌﾟﾗﾝｸﾃｲｽｳ	プランク定数	名詞
ﾌﾟﾗﾝﾄﾙｸﾞﾗｳｱｰﾄ	プラントル・グラウアート	人名
ﾌﾟﾗﾝﾄﾙｽｳ	プラントル数	名詞
ﾌﾟﾗｽﾄﾒｰﾀｰ	プラストメーター	名詞
ﾌﾟﾗｽﾞﾏﾌﾞﾝｻﾝｶﾝｽｳ	プラズマ分散関数	名詞
ﾌﾟﾗｽﾞﾏﾌﾞﾂﾘｶﾞｸ	プラズマ物理学	名詞
ﾌﾟﾗｽﾞﾏﾃﾞﾝｲ	プラズマ電位	名詞
ﾌﾟﾗｽﾞﾏｴｺｰ	プラズマエコー	名詞
ﾌﾟﾗｽﾞﾏｹﾞﾝ	プラズマ源	名詞
ﾌﾟﾗｽﾞﾏﾌｱﾝﾃｲｾｲ	プラズマ不安定性	名詞
ﾌﾟﾗｽﾞﾏｶﾈﾂ	プラズマ加熱	名詞
ﾌﾟﾗｽﾞﾏｶｿｸｷ	プラズマ加速器	名詞
ﾌﾟﾗｽﾞﾏｼﾝﾀﾞﾝ	プラズマ診断	名詞
ﾌﾟﾗｽﾞﾏｼﾝﾄﾞｳ	プラズマ振動	名詞
ﾌﾟﾗｽﾞﾏﾄｼﾞｺﾒ	プラズマ閉込め	名詞
ﾌﾟﾗｽﾞﾏﾕｳｺｳﾁｮｳ	プラズマ有効長	名詞
ﾌﾟﾗｽﾞﾏｼﾞｭｳ	プラズマ銃	名詞
ﾌﾟﾗｽﾞﾓｲﾄﾞ	プラズモイド	名詞
ﾌﾟﾗｽﾞﾓﾝ	プラズモン	名詞
ﾌﾟﾗｽﾞﾓﾝﾚｲｷ	プラズモン励起	名詞
ﾌﾟﾗｽﾞﾓﾝｻﾝﾗﾝ	プラズモン散乱	名詞
ﾌﾟﾚｰﾄﾌｧｸﾀｰ	プレートファクター	名詞
ﾌﾟﾚｰﾄﾃｸﾄﾆｸｽ	プレートテクトニクス	名詞
ﾌﾟﾘｺﾞｼﾞﾝﾉﾃｲﾘ	プリゴジンの定理	名詞
ﾌﾟｰﾘｰ	プーリー	名詞
ﾌﾟﾘﾏｺﾌｺｳｶ	プリマコフ効果	名詞
ﾌﾟﾘｽﾞﾏﾁｯｸﾃﾝｲﾙｰﾌﾟ	プリズマチック転移ループ	名詞
ﾌﾟﾛｰﾌﾞ	プローブ	名詞
ﾌﾟﾛｸﾞﾚｯｼｮﾝ	プログレッション	名詞
ﾌﾟﾛｶﾎｳﾃｲｼｷ	プロカ方程式	名詞
ﾌﾟﾛﾊﾟｰﾁｬﾈﾘﾝｸﾞ	プロパーチャネリング	名詞
ﾌﾟﾙﾌﾘﾋｿｯｺｳｷ	プルフリキ測光器	名詞
ﾌﾟﾙﾗﾙｻﾝﾗﾝ	プルラル散乱	名詞
ﾌﾟｯｼｭﾌﾟﾙｿﾞｳﾌｸｷ	プッシュプル増幅器	名詞
Qﾃﾞﾝｼﾞｼｬｸ	Q電磁石	名詞
Qﾉﾜｻﾞ	Qの技	名詞
Qｽｳ	q数	名詞
Qｽｲｯﾁﾚｰｻﾞｰ	Qスイッチレーザー	名詞
Qｽｲｯﾁﾚｰｻﾞｰ	{\itQ}スイッチレーザー	名詞
Qﾁ	Q値	名詞
Qﾁ	{\itQ}値	名詞
ﾛｰｶﾞﾀﾆｼﾞｭｳｺｳ	ρ型二重項	名詞
ﾛｰｶﾞﾀﾆｼﾞｭｳｺｳ	$\rho$型二重項	名詞
ﾛｰｶﾞﾀﾆｼﾞｭｳｺｳ	\rho型二重項	名詞
Rﾁｬｯｼﾝｷ	RC発振器	名詞
RCｹﾂｺﾞｳ	RC結合	名詞
RFﾎｳﾃﾞﾝｶﾞﾀｲｵﾝｹﾞﾝ	RF放電型イオン源	名詞
Rｯﾌｳｼﾞｺﾒ	RF封込め	名詞
RFﾌｳｼﾞｺﾒ	RF封込め	名詞
RFｶｿｸ	RF加速	名詞
ﾘﾃﾞﾝｷｮｸ	RI電極	名詞
ﾘﾝｼ	R因子	名詞
RKRﾎﾟﾃﾝｼｬﾙｷｮｸｾﾝ	RKRポテンシャル曲線	名詞
Rﾉｴﾀﾞ	Rの枝	名詞
Rﾊﾟｷﾝｼﾞ	RPA近似	名詞
ﾗﾊﾞﾙｶﾝ	ラバル管	名詞
ﾗｰﾍﾞｽｿｳ	ラーベス相	名詞
ﾗﾌﾞﾊ	ラブ波	名詞
ﾗﾃﾞｨｴｰｼｮﾝｹﾞｰｼﾞ	ラディエーションゲージ	名詞
ﾗﾄﾞ	ラド	名詞
ﾗｹﾞｰﾙﾀｺｳｼｷ	ラゲール多項式	名詞
ﾗｸﾞﾗﾝｼﾞｱﾝ	ラグランジアン	名詞
ﾗｸﾞﾗﾝｼﾞｭ	ラグランジュ	人名
ﾗｸﾞﾗﾝｼﾞｭ	Lagrange	人名
ﾗｸﾞﾗﾝｼﾞｭｶｯｺ	ラグランジュ括弧	名詞
ﾗｸﾞﾗﾝｼﾞｭｶﾝｽｳ	ラグランジュ関数	名詞
ﾗｸﾞﾗﾝｼﾞｭﾉｺﾏ	ラグランジュのこま	名詞
ﾐﾃｲｼﾞｮｳｽｳﾎｳ	未定乗数法	名詞
ﾘｭｳﾀｲｳﾝﾄﾞｳﾎｳﾃｲｼｷ	流体運動方程式	名詞
ｳｽﾞﾃﾝﾃｲﾘ	渦点定理	名詞
ﾗｸﾞﾗﾝｼﾞｭﾃﾝ	ラグランジュ点	名詞
ﾗｯﾌﾆﾝｸﾞﾃﾝｲ	ラッフニング転移	名詞
ﾗｲﾃﾞﾝﾋﾞﾝ	ライデン瓶	名詞
ﾗｲﾎｳﾃﾞﾝ	雷放電	名詞
ﾗｲﾏﾝ	ライマン	人名
ﾗｲﾏﾝ	Lyman	人名
ﾗｲﾏﾝｱﾙﾌｧｾﾝ	ライマンα線	名詞
ﾗｲﾏﾝｱﾙﾌｧｾﾝ	ライマン$\alpha$線	名詞
ﾗｲﾏﾝｱﾙﾌｧｾﾝ	ライマン\alpha線	名詞
ﾗｲﾏﾝｺﾞｰｽﾄ	ライマンゴースト	名詞
ﾗｲﾏﾝｹｲﾚﾂ	ライマン系列	名詞
ﾗｲﾄｶﾞｲﾄﾞ	ライトガイド	名詞
ﾗｲﾄｺｰﾝ	ライトコーン	名詞
ﾗｲﾄﾊﾟｲﾌﾟ	ライトパイプ	名詞
ﾗｶｰｹｲｽｳ	ラカー係数	名詞
ﾗｯｶｳﾝﾄﾞｳ	落下運動	名詞
ﾗｯｷｭｳﾈﾝﾄﾞｹｲ	落球粘度計	名詞
ﾗﾏﾝ	ラマン	人名
ﾗﾏﾝ	Raman	人名
ﾗﾏﾝﾌﾞﾝｺｳ	ラマン分光	名詞
ﾗﾏﾝﾌｶｯｾｲ	ラマン不活性	連体詞
ﾗﾏﾝｶｯｾｲ	ラマン活性	連体詞
ﾗﾏﾝｹﾝﾋﾞｷｮｳ	ラマン顕微鏡	名詞
ﾗﾏﾝｺｳｶ	ラマン効果	名詞
ﾗﾏﾝﾏｲｸﾛﾌﾟﾛｰﾌﾞ	ラマンマイクロプローブ	名詞
ﾗﾏﾝﾅｽｶｲｾﾂ	ラマン・ナス回折	名詞
ﾗﾏﾝﾚｰｻﾞｰ	ラマンレーザー	名詞
ﾗﾏﾝｻﾝﾗﾝ	ラマン散乱	名詞
ﾗｰﾒﾉﾃｲｽｳ	ラーメの定数	名詞
ﾗﾒﾗｰ	ラメラー	人名
ｺｳｼｶﾝｼｮｳﾌﾞﾝｺｳｷ	格子干渉分光器	名詞
ﾗﾐﾉﾃｲﾘ	ラミの定理	名詞
ﾗｰﾓｱ	ラーモア	人名
ﾗｰﾓｱ	Larmor	人名
ﾗｰﾓｱﾊﾝｹｲ	ラーモア半径	名詞
ﾗｰﾓｱﾊﾝｼﾞｾｲ	ラーモア反磁性	名詞
ﾗｰﾓｱｶｲﾃﾝ	ラーモア回転	名詞
ﾗｰﾓｱﾉﾃｲﾘ	ラーモアの定理	名詞
ﾗｰﾓｱｻｲｻｳﾝﾄﾞｳ	ラーモア歳差運動	名詞
ﾗｰﾓｱｼﾝﾄﾞｳｽｳ	ラーモア振動数	名詞
ﾗﾑﾃﾞｨｯﾌﾟ	ラムディップ	名詞
ﾗﾑﾊ	ラム波	名詞
ﾗﾑｼﾌﾄ	ラムシフト	名詞
ﾗﾑｻﾞｳｱｰﾀｳﾝｾﾞﾝﾄﾞ	ラムザウアー・タウンゼンド	人名
ﾗﾑｾﾞｰｷｮｳﾒｲ	ラムゼー共鳴	名詞
ﾗﾝﾍﾞﾙﾄﾍﾞｰﾙﾉﾎｳｿｸ	ランベルト・ベールの法則	名詞
ﾗﾝﾍﾞﾙﾄﾉﾎｳｿｸ	ランベルトの法則	名詞
ﾗﾝﾀﾞﾑｺｲﾙﾓｹｲ	ランダムコイル模型	名詞
ﾗﾝﾀﾞﾑｼｭｳﾘｮｳ	ランダム収量	名詞
ﾗﾝﾀﾞﾑｳﾝﾄﾞｳ	ランダム運動	名詞
ﾗﾝﾀﾞﾑｳｫｰｸ	ランダムウォーク	名詞
ﾗﾝﾀﾞｳ	ランダウ	人名
ﾗﾝﾀﾞｳ	Landau	人名
ﾗﾝﾀﾞｳｹﾞﾝｽｲ	ランダウ減衰	名詞
ﾗﾝﾀﾞｳｹﾞｰｼﾞ	ランダウゲージ	名詞
ﾗﾝﾀﾞｳﾊﾝｼﾞｾｲ	ランダウ反磁性	名詞
ﾗﾝﾀﾞｳﾉﾕﾗｷﾞ	ランダウのゆらぎ	名詞
ﾗﾝﾀﾞｳﾊﾞｲｴﾙｽｺｳｼｷ	ランダウ・バイエルス公式	名詞
ﾗﾝﾀﾞｳﾎﾟﾒﾗﾝﾁｭｸｺｳｶ	ランダウ・ポメランチュク効果	名詞
ﾗﾝﾀﾞｳﾙｰﾏｰｿﾝｼﾂ	ランダウ・ルーマー損失	名詞
ﾗﾝﾀﾞｳﾘｮｳｼｶ	ランダウ量子化	名詞
ﾗﾝﾀﾞｳｾﾞｰﾅｰﾉﾘﾛﾝ	ランダウ・ゼーナーの理論	名詞
ﾗﾝﾀﾞｳｼﾞｭﾝｲ	ランダウ準位	名詞
ﾗﾝﾃﾞﾉｷﾞﾝｼ	ランデのg因子	名詞
ﾗﾝﾀﾞｳﾉｶﾝｶｸｿｸ	ランダウの間隔則	名詞
ﾗﾝｸﾞﾎｳ	ラング法	名詞
ﾗﾝｸﾞｶﾒﾗ	ラングカメラ	名詞
ﾗﾝｸﾞﾐｭｱ	ラングミュア	名詞
ﾌﾞﾛｼﾞｪｯﾄﾏｸ	・ブロジェット膜	人名
ﾗﾝｸﾞﾐｭｱﾉｼｷ	ラングミュアの式	名詞
ﾗﾝｸﾞﾐｭｱﾌﾟﾛｰﾌﾞ	ラングミュアプローブ	名詞
ﾗﾝｷﾝﾕｺﾞﾆｵﾉｶﾝｹｲ	ランキン・ユゴニオの関係	名詞
ﾗﾝﾘｭｳｶｸｻﾝ	乱流拡散	名詞
ﾗﾝﾘｭｳｶﾈﾂ	乱流加熱	名詞
ﾗﾝﾘｭｳﾉｶﾝｹﾂｾｲ	乱流の間欠性	名詞
ﾗﾝﾀﾅｲﾄﾞ	ランタナイド	名詞
ﾗﾝｻﾞﾂｷﾞｮｳﾚﾂ	乱雑行列	名詞
ﾗﾝｻﾞﾂｲｿｳｷﾝｼﾞ	乱雑位相近似	名詞
ﾗﾝｻﾞﾂｼﾞｭｳﾃﾝｺｳｿﾞｳ	乱雑充填構造	名詞
ﾗﾝｼﾞｭﾊﾞﾝ	ランジュバン	人名
ﾗﾝｼﾞｭﾊﾞﾝ	Langevin	人名
ﾗﾝｼﾞｭﾊﾞﾝﾎｳﾃｲｼｷ	ランジュバン方程式	名詞
ﾗﾝｼﾞｭﾊﾞﾝｶﾝｽｳ	ランジュバン関数	名詞
ﾗﾝｼﾞｭﾊﾞﾝｼﾝﾄﾞｳｼ	ランジュバン振動子	名詞
ﾗﾋﾟﾃﾞｨﾃｨ	ラピディティ	名詞
ﾗﾎﾟﾙﾃﾉｷｿｸ	ラポルテの規則	名詞
ﾗﾌﾟﾗｼｱﾝ	ラプラシアン	名詞
ﾗﾌﾟﾗｽ	ラプラス	人名
ﾗﾌﾟﾗｽ	Laplace	人名
ﾗﾌﾟﾗｽﾍﾝｶﾝ	ラプラス変換	名詞
ﾗﾌﾟﾗｽﾎｳﾃｲｼｷ	ラプラス方程式	名詞
ﾗﾌﾟﾗｽﾉﾃﾞﾓﾝ	ラプラスのデモン	名詞
ﾗﾘﾀｼｭｳｨﾝｶﾞｰ	ラリタ・シュウィンガー	人名
ﾗｾﾐﾀｲ	ラセミ体	名詞
ﾗｾﾝｺｳｿﾞｳ	らせん構造	名詞
ﾗｾﾝﾀｲｼｮｳ	らせん対称	名詞
ﾗｾﾝﾃﾝｲ	らせん転位	名詞
ﾗｾﾝｳﾝﾄﾞｳ	らせん運動	名詞
ﾗｾﾝｼﾞｷｺｳｿﾞｳ	らせん磁気構造	名詞
ﾗｾﾝｼﾞｸ	らせん軸	名詞
ﾗｯｾﾙｿﾝﾀﾞｰｽﾞｹﾂｺﾞｳ	ラッセル・ソンダーズ結合	名詞
ﾗﾃｯｸｽ	ラテックス	名詞
ﾗﾃｨｽ	ラティス	名詞
ﾗﾄｶﾞｰﾉｶﾝｹｲｼｷ	ラトガーの関係式	名詞
ﾗｯﾃｨﾝｼﾞｬｰﾉﾃｲﾘ	ラッティンジャーの定理	名詞
ﾗｳｴ	ラウエ	人名
ﾗｳｴ	Laue	人名
ﾗｳｴｸﾞﾝ	ラウエ群	名詞
ﾗｳｴﾊﾝﾃﾝ	ラウエ斑点	名詞
ﾗｳｴﾎｳ	ラウエ法	名詞
ﾗｳｴｶﾒﾗ	ラウエカメラ	名詞
ﾗｳｴｶﾝｽｳ	ラウエ関数	名詞
ﾗｳｴﾉｶｲｾﾂｼﾞｮｳｹﾝ	ラウエの回折条件	名詞
ﾗｳｴﾉﾃｲﾘ	ラウエの定理	名詞
ﾗｳｴｿﾞｰﾝ	ラウエゾーン	名詞
ﾗｳｴｽﾞｹｲ	ラウエ図形	名詞
ﾗｳｰﾙﾉﾎｳｿｸ	ラウールの法則	名詞
ﾗｳｽﾓｹｲ	ラウス模型	名詞
ﾗｻﾞﾌｫｰﾄﾞﾉｹﾞﾝｼﾓｹｲ	ラザフォードの原子模型	名詞
ﾗｻﾞﾌｫｰﾄﾞｻﾝﾗﾝ	ラザフォード散乱	名詞
ﾗｼﾞｵﾒｰﾀｰﾘｮｸ	ラジオメーター力	名詞
ﾚﾋﾞﾝｿﾝﾉﾃｲﾘ	レビンソンの定理	名詞
ﾚｯﾄﾞﾍｯﾄﾞｹﾞｰｼﾞ	レッドヘッドゲージ	名詞
ﾚｯﾄﾞｼﾌﾄ	レッドシフト	名詞
ﾚｷﾞｭﾚｰﾀｰ	レギュレーター	名詞
ﾚｯﾍﾙｾﾝ	レッヘル線	名詞
ﾚｲﾌｨﾙﾀｰ	冷フィルター	名詞
ﾚｲｶﾞｲｶﾞﾀﾘｰｸﾞﾝ	例外型リー群	名詞
ﾚｲｲﾎｳ	零位法	名詞
ﾚｲｲﾝｷｮｸ	冷陰極	名詞
ﾚｲｲﾝｷｮｸﾎｳﾃﾞﾝｶﾝ	冷陰極放電管	名詞
ﾚｲｲﾝｷｮｸﾎｳｼｭﾂ	冷陰極放出	名詞
ﾚｲｶﾝｶｺｳ	冷間加工	名詞
ﾚｲｷﾃﾞﾝｱﾂ	励起電圧	名詞
ﾚｲｷｴﾈﾙｷﾞｰ	励起エネルギー	名詞
ﾚｲｷｲｺｳ	励起移行	名詞
ﾚｲｷｶﾝｽｳ	励起関数	名詞
ﾚｲｷｺｳｹﾞﾝ	励起光源	名詞
ﾚｲｷｼ	励起子	名詞
ﾚｲｷｼﾌﾞﾝｼ	励起子分子	名詞
ﾚｲｷｼｷﾞｮｳｼｭｸ	励起子凝縮	名詞
ﾚｲｷｼｷｭｳｼｭｳ	励起子吸収	名詞
ﾚｲｷｽﾍﾟｸﾄﾙ	励起スペクトル	名詞
ﾚｲｷｼﾞｮｳﾀｲ	励起状態	名詞
ﾚｲﾝﾎﾞｰｻﾝﾗﾝ	レインボー散乱	名詞
ﾚｲﾉﾙｽﾞｵｳﾘｮｸ	レイノルズ応力	名詞
ﾚｲﾉﾙｽﾞｽｳ	レイノルズ数	名詞
ﾚｲﾘｰ	レイリー	人名
ﾚｲﾘｰ	Rayleigh	人名
ﾚｲﾘｰﾊﾞﾝ	レイリー板	名詞
ﾚｲﾘｰｴﾝﾊﾞﾝ	レイリー円板	名詞
ﾚｲﾘｰﾊ	レイリー波	名詞
ﾚｲﾘｰｶﾝｼｮｳｹｲ	レイリー干渉計	名詞
ﾚｲﾘｰｷｼﾞｭﾝ	レイリー基準	名詞
ﾚｲﾘｰｸｯｾﾂｹｲ	レイリー屈折計	名詞
ﾚｲﾘｰﾉｹﾞﾝﾘ	レイリーの原理	名詞
ﾚｲﾘｰﾉｶｲｿﾞｳｹﾞﾝｶｲ	レイリーの解像限界	名詞
ﾚｲﾘｰﾉﾅｶﾞﾚ	レイリーの流れ	名詞
ﾚｲﾘｰﾘｯﾂﾉﾎｳﾎｳ	レイリー・リッツの方法	名詞
ﾚｲﾘｰｻﾝﾗﾝ	レイリー散乱	名詞
ﾚｲﾘｰｽｳ	レイリー数	名詞
ﾚｲﾘｰﾃｲﾗｰﾉﾌｱﾝﾃｲ	レイリー・テイラーの不安定	名詞
ﾚｲﾘｰｼﾞｰﾝｽﾞ	レイリー・ジーンズ	人名
ﾚｲｾｯﾃﾝ	冷接点	名詞
ﾚｲｼﾝ	励振	名詞
ﾚｲﾃﾝｴﾈﾙｷﾞｰ	零点エネルギー	名詞
ﾚｲﾃﾝﾎｳ	零点法	名詞
ﾚｲﾃﾝｼﾝﾄﾞｳ	零点振動	名詞
ﾚｲﾃﾝｼﾝﾄﾞｳｶｸﾊﾝﾉｳ	零点振動核反応	名詞
ﾚｲﾄｳﾉｳﾘｮｸ	冷凍能力	名詞
ﾚｲﾄｳｻｲｸﾙ	冷凍サイクル	名詞
ﾚｲﾄｳﾄﾝ	冷凍トン	名詞
ﾚｲﾁｭｳｾｲｼ	冷中性子	名詞
ﾚｲｼﾞ	励磁	名詞
ﾚｲｼﾞﾃﾞﾝﾘｭｳ	励磁電流	名詞
ﾚｷﾋｮｳｼﾞ	暦表時	名詞
ﾚｯｶｳﾗﾝ	劣化ウラン	名詞
ﾚﾑｶｳﾝﾀｰ	レムカウンター	名詞
ﾚﾅｰﾄﾞｼﾞｮｰﾝｽﾞ	レナード・ジョーンズ	人名
ﾚﾅｰｺｳｶ	レナー効果	名詞
ﾚﾆﾝｶﾞｰｺｳｶ	レニンガー効果	名詞
ﾚﾝｻﾊﾝﾉｳ	連鎖反応	名詞
ﾚﾝｾｲｼﾝﾄﾞｳ	連成振動	名詞
ﾚﾝﾂｲｪﾝｾﾞﾝﾎﾟﾃﾝｼｬﾙ	レンツ・イェンゼンポテンシャル	名詞
ﾚﾝﾂﾉﾎｳｿｸ	レンツの法則	名詞
ﾚﾝｿﾞｸｴﾈﾙｷﾞｰｼﾞｭﾝｲ	連続エネルギー準位	名詞
ﾚﾝｿﾞｸｹﾞﾝｿｸﾓﾃﾞﾙ	連続減速モデル	名詞
ﾚﾝｿﾞｸｸﾞﾝ	連続群	名詞
ﾚﾝｿﾞｸﾎｳﾃｲｼｷ	連続方程式	名詞
ﾚﾝｿﾞｸｺﾕｳﾁ	連続固有値	人名
ﾚﾝｿﾞｸﾉﾎｳﾃｲｼｷ	連続の方程式	名詞
ﾚﾝｿﾞｸﾎﾟﾃﾝｼｬﾙ	連続ポテンシャル	名詞
ﾚﾝｿﾞｸｽﾍﾟｸﾄﾙ	連続スペクトル	名詞
ﾚﾝｿﾞｸﾀｲ	連続体	名詞
ﾚﾝｿﾞｸXｾﾝ	連続X線	名詞
ﾚｵｺﾞﾆﾒｰﾀｰ	レオゴニメーター	名詞
ﾚｵﾒｰﾀｰ	レオメーター	名詞
ﾚｵﾍﾟｸｼｰ	レオペクシー	名詞
ﾚｵﾛｼﾞｰ	レオロジー	名詞
ﾚﾌﾟﾘｶﾎｳ	レプリカ法	名詞
ﾚﾌﾟﾘｶｶｲｾﾂｺｳｼ	レプリカ回折格子	名詞
ﾚﾌﾟﾄﾝ	レプトン	名詞
ﾚﾌﾟﾄﾝｽｳ	レプトン数	名詞
ﾚﾘｯﾋﾃﾞｨｷｼﾐｴﾉﾃｲﾘ	レリッヒ・ディキシミエの定理	名詞
ﾚｻｼﾞｰ	レサジー	名詞
ﾚｽﾎﾟﾝｽｶﾝｽｳ	レスポンス関数	名詞
ﾚｰﾄﾎｳﾃｲｼｷ	レート方程式	名詞
ﾚｰｻﾞｰｱﾆｰﾘﾝｸﾞ	レーザーアニーリング	名詞
ﾚｰｻﾞｰﾊﾞｲｼﾂ	レーザー媒質	名詞
ﾚｰｻﾞｰﾌﾞﾝｺｳ	レーザー分光	名詞
ﾚｰｻﾞｰﾌﾞﾝｺｳﾎｳ	レーザー分光法	名詞
ﾚｰｻﾞｰﾀﾞｲｵｰﾄﾞ	レーザーダイオード	名詞
ﾚｰｻﾞｰﾄﾞｳｲﾀｲﾌﾞﾝﾘ	レーザー同位体分離	名詞
ﾚｰｻﾞｰﾄﾞｯﾌﾟﾗｰ	レーザードップラー	名詞
ﾚｰｻﾞｰﾊﾁｮｳｹｲ	レーザー波長計	名詞
ﾚｰｻﾞｰﾎｳﾃﾞﾝ	レーザー放電	名詞
ﾚｰｻﾞｰｶｺｳ	レーザー加工	名詞
ﾚｰｻﾞｰｶｸﾕｳｺﾞｳ	レーザー核融合	名詞
ﾚｰｻﾞｰｷｮｳｼﾝｷ	レーザー共振器	名詞
ﾚｰｻﾞｰﾚｲｷｬｸ	レーザー冷却	名詞
ﾚｰｻﾞｰｾｲｾｲﾌﾟﾗｽﾞﾏ	レーザー生成プラズマ	名詞
ﾚｰｻﾞｰｿﾝｼｮｳ	レーザー損傷	名詞
ﾚｰｻﾞｰｼｭﾀﾙｸﾌﾞﾝｺｳ	レーザーシュタルク分光	名詞
ﾚｰｻﾞｰﾕｳｷｶｶﾞｸﾊﾝﾉｳ	レーザー誘起化学反応	名詞
ﾕｳｷｹｲｺｳﾌﾞﾝｺｳﾎｳ	誘起蛍光分光法	名詞
ﾚｰｻﾞｰｼﾞｷｷｮｳﾒｲ	レーザー磁気共鳴	名詞
ﾚｰｻﾞｰｿﾞｳﾌｸｷ	レーザー増幅器	名詞
ﾚｰｻﾞｰｼﾞｬｲﾛｽｺｰﾌﾟ	レーザージャイロスコープ	名詞
ﾚｿﾞﾙﾍﾞﾝﾄ	レゾルベント	名詞
ﾚｯｼﾞｪｷｮｸ	レッジェ極	名詞
ﾘｱｸﾀﾝｽ	リアクタンス	名詞
ﾘｱｸﾀﾝｽｶﾝｽｳ	リアクタンス関数	名詞
ﾘｱｸﾄﾙ	リアクトル	名詞
ﾘﾋﾞｰｶｳﾝﾀｰ	リビーカウンター	名詞
ﾘﾋﾞﾝｸﾞﾎﾟﾘﾏｰ	リビングポリマー	名詞
ﾘﾎﾞｶｸｻﾝ	リボ核酸	名詞
ﾘﾌﾞﾛﾝ	リブロン	名詞
ﾘﾃﾞﾝｻﾞｯｸｽﾃﾗｰ	リデン・ザックス・テラー	人名
ﾘﾋﾃﾝﾍﾞﾙｸｽﾞｹｲ	リヒテンベルク図形	名詞
ﾘﾌｼｯﾂ	リフシッツ	人名
ﾘﾌｼｯﾂ	Lifshitz	人名
ﾘﾌｼｯﾂﾌﾍﾝｼｷ	リフシッツ不変式	名詞
ﾘﾌｼｯﾂﾃﾝ	リフシッツ点	名詞
ﾘﾌｼｯﾂｼﾞｮｳｹﾝ	リフシッツ条件	名詞
ﾘｰ	リー	人名
ﾘｰ	Lie	人名
ﾘｰﾀﾞｲｽｳ	リー代数	名詞
ﾘｰｷﾞﾙﾃﾞｭｯｸｺｳｶ	リーギ・ルデュック効果	名詞
ﾘｰｸﾞﾝ	リー群	人名
ﾘｰｶﾝ	リー環	名詞
ﾘｰｸﾍﾞﾝ	リーク弁	名詞
ﾘｰｸﾘｮｳ	リーク量	名詞
ﾘｰｸﾃｽﾄ	リークテスト	名詞
ﾘｰﾏﾝ	リーマン	人名
ﾘｰﾏﾝ	Riemann	人名
ﾘｰﾏﾝｶｶｶﾞｸ	リーマン幾何学	名詞
ﾘｰﾏﾝｸｳｶﾝ	リーマン空間	名詞
ﾘｰﾏﾝｸﾘｽﾄｯﾌｪﾙ	リーマン・クリストッフェル	人名
ﾘｰｾｷ	リー積	名詞
ﾘｰｽﾉﾃｲﾘ	リースの定理	名詞
ﾘｰﾔﾝﾉｴﾝﾃｲﾘ	リー・ヤンの円定理	名詞
ﾘｷｶﾞｸｶﾝﾜ	力学緩和	名詞
ﾘｷｶﾞｸｼｻ	力学視差	名詞
ﾘｷｶﾞｸﾃｷｴﾈﾙｷﾞｰ	力学的エネルギー	名詞
ﾎｿﾞﾝﾉﾎｳｿｸ	保存の法則	名詞
ﾘｷｶﾞｸﾃｷｼｾﾞﾝｶﾝ	力学的自然観	名詞
ﾘｷｶﾞｸﾃｷｿｶﾃｲ	力学的素過程	名詞
ﾘｷｶﾞｸﾃｷﾀｲｼｮｳｾｲ	力学的対称性	名詞
ﾘｷﾘﾂ	力率	名詞
ﾘｷｾｷ	力積	名詞
ﾘｷｾｷﾓｰﾒﾝﾄ	力積モーメント	名詞
ﾘｷｾﾝ	力線	名詞
ﾘﾐｯﾀｰ	リミッター	名詞
ﾘﾐｯﾄｻｲｸﾙ	リミットサイクル	名詞
ﾘﾝﾃﾞｴｷｶｻｲｸﾙ	リンデ液化サイクル	名詞
ﾘﾝﾃﾞﾏﾝﾉﾕｳｶｲｿｸ	リンデマンの融解則	名詞
ﾘﾝﾃﾞｿｸ	リンデ則	名詞
ﾘﾝｷﾞﾝｸﾞ	リンギング	名詞
ﾘﾝｸﾞｶｸｻﾝ	リング拡散	名詞
ﾘﾝｸﾞﾚｰｻﾞｰ	リングレーザー	名詞
ﾘﾆｱｯｸ	リニアック	名詞
ﾘﾆｱﾓｰﾀｰ	リニアモーター	名詞
ﾘﾆｴｰｼﾞｺｳｿﾞｳ	リニエージ構造	名詞
ﾘﾝｶｲｱﾂﾘｮｸ	臨界圧力	名詞
ﾘﾝｶｲｱﾂ	臨界圧	名詞
ﾘﾝｶｲﾃﾞﾝﾘｭｳ	臨界電流	名詞
ﾘﾝｶｲｴﾈﾙｷﾞｰ	臨界エネルギー	名詞
ﾘﾝｶｲｹﾞﾝｽｲ	臨界減衰	名詞
ﾘﾝｶｲｹﾞﾝｽｲｶｲﾛ	臨界減衰回路	名詞
ﾘﾝｶｲｹﾞﾝｼｮｳ	臨界現象	名詞
ﾘﾝｶｲﾊｲｱﾂ	臨界背圧	名詞
ﾘﾝｶｲﾋﾀｲｾｷ	臨界比体積	名詞
ﾘﾝｶｲﾎｳﾃｲｾｷ	臨界方程式	名詞
ﾘﾝｶｲｶｸ	臨界角	名詞
ﾘﾝｶｲｶｸ	臨界核	名詞
ﾘﾝｶｲｶﾝﾜ	臨界緩和	名詞
ﾘﾝｶｲｹﾂｺﾞｳ	臨界結合	名詞
ﾘﾝｶｲｷｮｳﾖｳｹﾞﾝｼｮｳ	臨界共溶現象	名詞
ﾘﾝｶｲﾏｯﾊｽｳ	臨界マッハ数	名詞
ﾘﾝｶｲﾐﾏﾝ	臨界未満	連体詞
ﾘﾝｶｲｵﾝﾄﾞ	臨界温度	名詞
ﾘﾝｶｲﾚｲﾉﾙｽﾞｽｳ	臨界レイノルズ数	名詞
ﾘﾝｶｲｻﾝﾗﾝ	臨界散乱	名詞
ﾘﾝｶｲｾｲﾄﾞｳ	臨界制動	名詞
ﾘﾝｶｲｶｸｷﾝｷｮﾘ	臨界核近距離	名詞
ﾘﾝｶｲｾﾝﾀﾞﾝｵｳﾘｮｸ	臨界せん断応力	名詞
ﾘﾝｶｲｼｽｳ	臨界指数	名詞
ﾘﾝｶｲｼﾂﾘｮｳ	臨界質量	名詞
ﾘﾝｶｲｿｸﾄﾞ	臨界速度	名詞
ﾘﾝｶｲｼｭｳｺﾞｳﾀｲ	臨界集合体	名詞
ﾘﾝｶｲｼｭｳﾊｽｳ	臨界周波数	名詞
ﾘﾝｶｲﾀﾝﾊﾟｸｺｳ	臨界タンパク光	名詞
ﾘﾝｶｲﾃﾝ	臨界点	名詞
ﾘﾝｶｲﾖｳﾄﾞｳ	臨界揺動	名詞
ﾘﾝｶｲｼﾞﾊﾞ	臨界磁場	名詞
ﾘﾝｶｲｼﾞｯｹﾝ	臨界実験	名詞
ﾘﾝｶｲｼﾞｮｳｹﾝ	臨界条件	名詞
ﾘﾝｶｲｼﾞｮｳﾀｲ	臨界状態	名詞
ﾘﾝｺｳ	りん光	名詞
ﾘﾝｺｳﾀｲ	りん光体	名詞
ﾘﾝｸｷｺｳ	リンク機構	名詞
ﾘﾝﾘﾂﾃﾝｲ	林立転位	名詞
ﾘﾝﾄﾞﾊﾙﾄ	リンドハルト	人名
ﾘﾝﾄﾞﾊﾙﾄ	Lindhard	人名
ﾘﾝﾄﾞﾊﾙﾄﾉﾘﾛN	リンドハルトの理論	名詞
ﾘﾝﾄﾞﾊﾙﾄﾉｼｷ	リンドハルトの式	名詞
ﾘﾝﾄﾞﾊﾙﾄﾎﾟﾃﾝｼｬﾙ	リンドハルトポテンシャル	名詞
ﾘｵﾄﾛﾋﾟｯｸｴｷｼｮｳ	リオトロピック液晶	名詞
ﾘｯﾎﾟｳｺｳｿﾞｳ	立方構造	名詞
ﾘｯﾎﾟｳｼｮｳｹｲ	立方晶系	名詞
ﾘｯﾌﾟﾏﾝｼｭｳｨﾝｶﾞｰ	リップマン・シュウィンガー	人名
ﾘﾌﾟﾛﾝ	リプロン	名詞
ﾘﾌﾟﾙ	リプル	名詞
ﾘﾛﾝﾌﾞﾂﾘｶﾞｸ	理論物理学	名詞
ﾘｻﾝﾃｷｴﾈﾙｷﾞｰｼﾞｭﾝｲ	離散的エネルギー準位	名詞
ﾘｻﾝﾃｷｺﾕｳﾁ	離散的固有値	名詞
ﾘｻｰｼﾞｭﾉｽﾞｹｲ	リサージュの図形	名詞
ﾘｼﾝﾘﾂ	離心率	名詞
ﾘｿｳﾎﾞｰｽﾞｷﾀｲ	理想ボーズ気体	名詞
ﾘｿｳﾌｪﾙﾐｷﾀｲ	理想フェルミ気体	名詞
ﾘｿｸﾞﾗﾌｨｰ	リソグラフィー	名詞
ﾘｿｳｷﾀｲ	理想気体	名詞
ﾘｿｳﾘｭｳﾀｲ	理想流体	名詞
ﾘｿｳﾃｷﾌｶﾝｾﾞﾝｹｯｼｮｳ	理想的不完全結晶	名詞
ﾘｿｳﾃｷｶﾝｾﾞﾝｹｯｼｮｳ	理想的完全結晶	名詞
ﾘｿｳﾖｳｴｷ	理想溶液	名詞
ﾘｯｿｸ	律速	連体詞
ﾘｯｿｸｶﾃｲ	律速過程	名詞
ﾘﾄｸﾀｲｲｷﾊﾊﾞｾｷ	利得帯域幅積	名詞
ﾘﾄﾛｰｶﾞﾀﾌﾞﾝｺｳｷ	リトロー型分光器	名詞
ﾘﾄﾙｸﾞﾙｰﾌﾟ	リトルグループ	名詞
ﾘｯﾀｲﾊｲｻﾞ	立体配座	名詞
ﾘｯﾀｲｲｾｲ	立体異性	名詞
ﾘｯﾀｲｲｾｲﾀｲ	立体異性体	名詞
ﾘｯﾀｲｶｲﾛ	立体回路	名詞
ﾘｯﾀｲｶｸ	立体角	名詞
ﾘｯﾀｲｷｿｸｾｲ	立体規則性	名詞
ﾘｯﾀｲｷｿｸｾｲｺｳﾌﾞﾝｼ	立体規則性高分子	名詞
ﾘｯﾀｲｺｳｶ	立体効果	名詞
ﾘｯﾀｲｼ	立体視	名詞
ﾘｯﾀｲｼｮｳｶﾞｲ	立体障害	名詞
ﾘｯﾀｲﾄｸｲｾｲ	立体特異性	名詞
ﾘｯﾁﾃﾝｿﾙ	リッチテンソル	名詞
ﾘｯﾂﾎｳ	リッツ法	名詞
ﾘｯﾂｹﾂｺﾞｳｿｸ	リッツ結合則	名詞
ﾘﾁｬｰﾄﾞｿﾝﾀﾞｯｼｭﾏﾝ	リチャードソン・ダッシュマン	人名
ﾘﾁｬｰﾄﾞｿﾝｺｳｶ	リチャードソン効果	名詞
ﾘｳﾋﾞﾙ	リウビル	人名
ﾘｳﾋﾞﾙ	Liouville	人名
ﾘｳﾋﾞﾙｴﾝｻﾞﾝｼ	リウビル演算子	名詞
ﾘｳﾋﾞﾙﾎｳﾃｲｼｷ	リウビル方程式	名詞
ﾘｳﾋﾞﾙﾉﾃｲﾘ	リウビルの定理	名詞
ﾘｼﾞｯﾄﾞﾊﾞﾝﾄﾞﾓｹｲ	リジッドバンド模型	名詞
ﾛﾊﾞﾃﾞﾝｼ	ロバ電子	名詞
ﾛﾊﾞｰﾂｱﾂﾘｮｸｹｲ	ロバーツ圧力計	名詞
ﾛﾋﾞﾝｿﾝﾌｳｿｸｹｲ	ロビンソン風速計	名詞
ﾛｺﾞｽｷｰｺｲﾙ	ロゴスキーコイル	名詞
ﾛｸﾞﾀﾝﾌﾟﾛｯﾄ	ログタンプロット	名詞
ﾛｲﾄﾞﾉｶｶﾞﾐ	ロイドの鏡	名詞
ﾛｯｷﾝｸﾞｷｮｸｾﾝ	ロッキング曲線	名詞
ﾛｯｸｲﾝｿﾞｳﾌｸｷ	ロックイン増幅器	名詞
ﾛｯｸｳｪﾙｶﾀｻ	ロックウェル硬さ	名詞
ﾛｯｷｮｸ	六極	連体詞
ﾛｺｳﾘｮｳ	露光量	名詞
ﾛｸｼﾞｭｳｺｳ	六重項	名詞
ﾛｸｼﾞｭｳｺｳｼﾞｮｳﾀｲ	六重項状態	名詞
ﾛｸｼﾞｭｳｾﾝ	六重線	名詞
ﾛｰﾏｰﾓｹｲ	ローマー模型	名詞
ﾛﾝﾄﾞﾝ	London	人名
ﾛﾝﾄﾞﾝﾎｳﾃｲｼｷ	ロンドン方程式	名詞
ﾛﾝﾄﾞﾝﾘﾛﾝ	ロンドン理論	名詞
ﾛﾝﾄﾞﾝﾁｮｳﾃﾞﾝﾄﾞｳﾀｲ	ロンドン超伝導体	名詞
ﾛﾝｸﾞｶｳﾝﾀｰ	ロングカウンター	名詞
ﾛﾝﾘｶｲﾛ	論理回路	名詞
ﾛｯﾎﾟｳｺｳｼ	六方格子	名詞
ﾛｯﾎﾟｳｼｮｳｹｲ	六方晶系	名詞
ﾛｯﾎﾟｳｻｲﾐﾂｺｳｿﾞｳ	六方最密構造	名詞
ﾛﾗﾝ	ロラン	名詞
ﾛｰﾗﾝﾄﾞｴﾝ	ローランド円	名詞
ﾛｰﾗﾝﾄﾞｺﾞｰｽﾄ	ローランドゴースト	名詞
ﾛｰﾚﾝﾂ	ローレンツ	人名
ﾛｰﾚﾝﾂ	Lorentz	人名
ﾛｰﾚﾝﾂｶﾞｽ	ローレンツガス	名詞
ﾛｰﾚﾝﾂｶﾞﾀ	ローレンツ型	連体詞
ﾛｰﾚﾝﾂｹﾞｰｼﾞ	ローレンツゲージ	名詞
ﾛｰﾚﾝﾂｸﾞﾝ	ローレンツ群	名詞
ﾛｰﾚﾝﾂﾍﾋﾞｻｲﾄﾞ	ローレンツ・ヘビサイド	人名
ﾛｰﾚﾝﾂﾍﾝｶﾝ	ローレンツ変換	名詞
ﾛｰﾚﾝﾂﾋ	ローレンツ比	名詞
ﾛｰﾚﾝﾂﾌﾍﾝｾｲ	ローレンツ不変性	名詞
ﾛｰﾚﾝﾂｷｮｸｼｮﾃﾞﾝﾊﾞ	ローレンツ局所電場	名詞
ﾛｰﾚﾝﾂﾛｰﾚﾝｽﾉｼｷ	ローレンツ・ローレンスの式	名詞
ﾛｰﾚﾝﾂﾘｮｸ	ローレンツ力	名詞
ﾛｰﾚﾝﾂｼｭｳｼｭｸ	ローレンツ収縮	名詞
ﾛｰﾘｯﾂｪﾝｹﾝﾃﾞﾝｷ	ローリッツェン検電器	名詞
ﾛｰｿﾝｼﾞｮｳｹﾝ	ローソン条件	名詞
ﾛｯｼｭｹﾞﾝｶｲ	ロッシュ限界	名詞
ﾛｽｺｰﾝ	ロスコーン	名詞
ﾛｼｪﾙｴﾝ	ロシェル塩	名詞
ﾛｼｮﾝﾌﾟﾘｽﾞﾑ	ロションプリズム	名詞
ﾛｼｭﾐｯﾄｽｳ	ロシュミット数	名詞
ﾛｼｭﾛｰﾌﾞ	ロシュローブ	名詞
ﾛｰｾﾞﾝﾌﾞﾙｰｽﾉｺｳｼｷ	ローゼンブルースの公式	名詞
ﾛｾﾞｯﾄｳﾝﾄﾞｳ	ロゼット運動	名詞
ﾛｰｽﾞｺﾞｰﾀﾞｰﾎｳ	ローズ・ゴーダー法	名詞
ﾛｰｽﾞｼﾑ	ローズシム	名詞
ﾙﾍﾞｰｸﾞｾｷﾌﾞﾝ	ルベーグ積分	名詞
ﾙﾋﾞｰﾚｰｻﾞｰ	ルビーレーザー	名詞
ﾙｲｾｷﾏｸ	累積膜	名詞
ﾙｰﾒﾝ	ルーメン	名詞
ﾙﾐﾈｾﾝｽ	ルミネセンス	名詞
ﾙﾐﾈｾﾝｽｾﾝﾘｮｳｹｲ	ルミネセンス線量計	名詞
ﾙﾐﾉｼﾃｨ	ルミノシティ	名詞
ﾙﾝｹﾞｸｯﾀﾎｳ	ルンゲ・クッタ法	名詞
ﾙﾝﾏｰﾌﾞﾛｰﾄﾞｩﾝ	ルンマー・ブロードゥン	人名
ﾙﾝﾏｰｹﾞｰﾙｹﾊﾞﾝ	ルンマー・ゲールケ板	名詞
ﾙﾝﾏｰｹﾞｰﾙｹｶﾝｼｮｳｹｲ	ルンマー・ゲールケ干渉計	名詞
ﾙｰﾌﾟﾃﾞﾝﾘｭｳ	ループ電流	名詞
ﾙｼｬﾄﾘｴﾉｹﾞﾝﾘ	ルシャトリエの原理	名詞
ﾙﾁﾙｶﾞﾀｺｳｿﾞｳ	ルチル型構造	名詞
ﾙｰﾂﾌﾞﾛｱｰ	ルーツブロアー	名詞
ﾙｰﾂﾎﾟﾝﾌﾟ	ルーツポンプ	名詞
ﾙｼﾞｬﾝﾄﾞﾙ	ルジャンドル	人名
ﾙｼﾞｬﾝﾄﾞﾙ	Legendre	人名
ﾙｼﾞｬﾝﾄﾞﾙﾊﾞｲｶﾝｽｳ	ルジャンドル陪関数	名詞
ﾙｼﾞｬﾝﾄﾞﾙｶﾝｽｳ	ルジャンドル関数	名詞
ﾙｼﾞｬﾝﾄﾞﾙﾀｺｳｼｷ	ルジャンドル多項式	名詞
ﾘｬﾌﾟﾉﾌｶﾝｽｳ	リャプノフ関数	名詞
ﾘｮｳﾌﾞﾘｶｼﾞｭｳ	両振荷重	名詞
ﾘｮｳﾌﾞﾘｵｳﾘｮｵｸ	両振り応力	名詞
ﾘｮｳｷｮｸｾｲｶｸｻﾝ	両極性拡散	名詞
ﾘｮｳﾒﾝﾀｲｼｮｳｹｲ	菱面体晶系	名詞
ﾘｮｳｾｲﾃﾞﾝｶｲｼﾂ	両性電解質	名詞
ﾘｮｳｼﾋﾞｰﾄﾌﾞﾝｺｳﾎｳ	量子ビート分光法	名詞
ﾘｮｳｼﾃﾞﾝｷﾘｷｶﾞｸ	量子電気力学	名詞
ﾘｮｳｼｴｷﾀｲ	量子液体	名詞
ﾘｮｳｼｴﾚｸﾄﾛﾆｸｽ	量子エレクトロニクス	名詞
ﾘｮｳｼﾎｾｲ	量子補正	名詞
ﾘｮｳｼｲﾄﾞ	量子井戸	名詞
ﾘｮｳｼｲﾛﾘｷｶﾞｸ	量子色力学	名詞
ﾘｮｳｼｶ	量子化	名詞
ﾘｮｳｼｶｵｽ	量子カオス	名詞
ﾘｮｳｼｶｾﾂ	量子仮説	名詞
ﾘｮｳｼｶｻﾞﾂｵﾝ	量子化雑音	名詞
ﾘｮｳｼｶｼﾞｸ	量子化軸	名詞
ﾘｮｳｼｹｯｿﾝ	量子欠損	名詞
ﾘｮｳｼｹｯｼｮｳ	量子結晶	名詞
ﾘｮｳｼｺｳｶﾞｸ	量子光学	名詞
ﾘｮｳｼｺｳｶ	量子効果	名詞
ﾘｮｳｼｺｳﾘﾂ	量子効率	名詞
ﾘｮｳｼｺﾀｲ	量子固体	名詞
ﾘｮｳｼｷｮｸｹﾞﾝ	量子極限	名詞
ﾘｮｳｼﾘｷｶﾞｸ	量子力学	名詞
ﾘｮｳｼﾛﾝ	量子論	名詞
ﾘｮｳｼﾛﾝﾘ	量子論理	名詞
ﾘｮｳｼｻｲｽﾞｺｳｶ	量子サイズ効果	名詞
ﾘｮｳｼｽｳ	量子数	名詞
ﾘｮｳｼｼｭｳﾘﾂ	量子収率	名詞
ﾘｮｳｼﾄｳｹｲﾘｷｶﾞｸ	量子統計力学	名詞
ﾘｮｳｼｳｽﾞ	量子渦	名詞
ﾘｮｳｼﾕﾗｷﾞ	量子ゆらぎ	名詞
ﾘｮｳｼｻﾞﾂｵﾝ	量子雑音	名詞
ﾘｮｳｼｼﾞｮｳﾀｲ	量子状態	名詞
ﾘｮｳｼｼﾞｭｳﾘｮｸ	量子重力	名詞
ﾘｮｳﾖｳﾊﾞｲ	良溶媒	名詞
ﾘｭｰﾀﾞｰｽﾀｲ	リューダース帯	名詞
ﾘｭｳﾄﾞ	粒度	名詞
ﾘｭｰﾄﾞﾍﾞﾘ	リュードベリ	人名
ﾘｭｰﾄﾞﾍﾞﾘ	Rydberg	人名
ﾘｭｰﾄﾞﾍﾞﾘｹﾞﾝｼ	リュードベリ原子	名詞
ﾘｭｰﾄﾞﾍﾞﾘｹｲﾚﾂ	リュードベリ系列	名詞
ﾘｭｰﾄﾞﾍﾞﾘﾘｯﾂ	リュードベリ・リッツ	人名
ｹﾂｺﾞｳｿｸ	結合則	名詞
ﾘｭｰﾄﾞﾍﾞﾘｾﾝｲ	リュードベリ遷移	名詞
ﾘｭｰﾄﾞﾍﾞﾘﾃｲｽｳ	リュードベリ定数	名詞
ﾘｭｰﾄﾞﾍﾞﾘｼﾞｮｳﾀｲ	リュードベリ状態	名詞
ﾘｭｳﾄﾞｳﾃﾞﾝｲ	流動電位	名詞
ﾘｭｳﾄﾞｳﾌｸｸｯｾﾂ	流動複屈折	名詞
ﾘｭｳﾄﾞｳﾆｼｮｸｾｲ	流動二色性	名詞
ﾘｭｳﾄﾞｳｵｳﾘｮｸ	流動応力	名詞
ﾘｭｳﾄﾞｳｻﾞﾝｺｳﾎｳ	流動残光法	名詞
ﾘｭｳｶｲ	粒界	名詞
ﾘｭｳｶｲｶｸｻﾝ	粒界拡散	名詞
ﾘｭｳｶｲｽﾍﾞﾘ	粒界すべり	名詞
ﾘｭｳｶｲﾃﾝｲ	粒界転位	名詞
ﾘｭｳｶｲﾜﾚ	粒界割れ	名詞
ﾘｭｳｶﾝ	流管	名詞
ﾘｭｳﾘｮｳｹｲ	流量計	名詞
ﾘｭｳｾｷｾﾝ	流跡線	名詞
ﾘｭｳｾﾝ	流線	名詞
ﾘｭｳｾﾝｹｲﾌﾞｯﾀｲ	流線型物体	名詞
ﾘｭｳｼﾋﾞｰﾑ	粒子ビーム	名詞
ﾘｭｳｼﾊﾝﾘｭｳｼﾍﾝｶﾝ	粒子-反粒子変換	名詞
ﾘｭｳｼﾍﾝｲ	粒子変位	名詞
ﾘｭｳｼｲｺｳﾊﾝﾉｳ	粒子移行反応	名詞
ﾘｭｳｼｶｲﾃﾝｼｹﾂｺﾞｳ	粒子-回転子結合	名詞
ﾘｭｳｼｶｿｸｷ	粒子加速器	名詞
ﾘｭｳｼｹﾝｼｭﾂｷ	粒子検出器	名詞
ﾘｭｳｼｸｳｺｳﾍﾝｶﾝ	粒子-空孔変換	名詞
ﾘｭｳｼｸｳｺｳﾘﾛﾝ	粒子-空孔理論	名詞
ﾘｭｳｼｸｳｺｳｿｳｺﾞｻﾖｳ	粒子-空孔相互作用	名詞
ﾘｭｳｼﾉﾁﾍｲ	粒子の地平	名詞
ﾘｭｳｼﾘｭｳｼｿｳｶﾝ	粒子-粒子相関	名詞
ﾘｭｳｼｾﾝ	粒子線	名詞
ﾘｭｳｼｾﾝﾌﾞﾝｺｳ	粒子線分光	名詞
ﾘｭｳｼｿｸﾄﾞ	粒子速度	名詞
ﾘｭｳｼｽﾍﾟｸﾄﾙ	粒子スペクトル	名詞
ﾘｭｳｿｸ	流束	名詞
ﾘｭｳｿｸﾐﾂﾄﾞ	流束密度	名詞
ﾘｭｳﾀｲﾓｹｲ	流体模型	名詞
ﾘｭｳﾀｲﾘｷｶﾞｸ	流体力学	名詞
ﾘｭｳﾀｲﾘｷｶﾞｸﾃｷ	流体力学的	連体詞
ﾘｭｳﾀｲｾｲﾘｷｶﾞｸ	流体静力学	名詞
ﾘｭｳﾀｲｿｼ	流体素子	名詞
ﾘｭｳｼﾞｮｳﾄﾞ	粒状度	名詞
ﾘｭｳｼﾞｮｳﾊﾝ	粒状斑	名詞
ｼｸﾞﾏｿｼ	σ素子	名詞
ｼｸﾞﾏｿｼ	$\sigma$素子	名詞
ｼｸﾞﾏｿｼ	\sigma素子	名詞
ｼｸﾞﾏｹﾂｺﾞｳ	σ結合	名詞
ｼｸﾞﾏｹﾂｺﾞｳ	$\sigma$結合	名詞
ｼｸﾞﾏｹﾂｺﾞｳ	\sigma結合	名詞
ｼｸﾞﾏｷﾄﾞｳ	σ軌道	名詞
ｼｸﾞﾏｷﾄﾞｳ	$\sigma$軌道	名詞
ｼｸﾞﾏｷﾄﾞｳ	\sigma軌道	名詞
ｼｸﾞﾏｷﾄﾞｳｶﾝｽｳ	σ軌道関数	名詞
ｼｸﾞﾏｷﾄﾞｳｶﾝｽｳ	$\sigma$軌道関数	名詞
ｼｸﾞﾏｷﾄﾞｳｶﾝｽｳ	\sigma軌道関数	名詞
ｼｸﾞﾏｼﾞｮｳﾀｲ	Σ状態	名詞
ｼｸﾞﾏｼﾞｮｳﾀｲ	${\mit\Sigma}$状態	名詞
ｼｸﾞﾏｼﾞｮｳﾀｲ	{\mit\Sigma}状態	名詞
SDｺｳｶﾝｿｳｺﾞｻﾖｳ	s-d交換相互作用	名詞
ｾｧFS	SEXAFS	名詞
Sｷﾞｮｳﾚﾂ	S行列	名詞
ｼｬ	S波	名詞
ｼｾｯﾄｳｺﾞ	SI接頭語	名詞
Sｷﾄﾞｳ	s軌道	名詞
Sｷﾄﾞｳｶﾝｽｳ	s軌道関数	名詞
Sｷｮｸ	S極	名詞
Sﾝﾋ	SN比	名詞
Sﾉｴﾀﾞ	Sの枝	名詞
ｿSｺｳｿﾞｳ	SOS構造	名詞
SQｳｲD	SQUID	名詞
Sﾁｬﾈﾙ	sチャネル	名詞
ｽ3ﾓｹｲ	SU(3)模型	名詞
ｽ3ﾀｲｼｮｳｾｲ	SU(3)対称性	名詞
ｻｱﾂｹｲ	差圧計	名詞
ｻｰﾊﾞｰﾎﾟﾃﾝｼｬﾙ	サーバーポテンシャル	名詞
ｻﾊﾞｰﾙﾊﾞﾝ	サバール板	名詞
ｻﾊﾞｰﾙﾉﾍﾝｺｳﾊﾞﾝ	サバールの偏光板	名詞
ｻｰﾊﾞｰﾘｮｸ	サーバー力	名詞
ｻｰﾎﾞｷｺｳ	サーボ機構	名詞
ｻｰﾎﾞﾓｰﾀｰ	サーボモーター	名詞
ｻｰﾎﾞｿﾞｳﾌｸ	サーボ増幅	名詞
ｻﾌﾞﾝﾋﾞﾌﾞﾝﾎｳﾃｲｼｷ	差分微分方程式	名詞
ｻﾌﾞﾝｺﾞｳｾｲ	差分合成	名詞
ｻﾌﾞﾝﾎｳ	差分法	名詞
ｻﾌﾞﾝﾎｳﾃｲｼｷ	差分方程式	名詞
ｻﾌﾞﾘﾒｰｼｮﾝﾎﾟﾝﾌﾟ	サブリメーションポンプ	名詞
ｻﾄﾞｳﾌﾞﾘｯｼﾞ	差動ブリッジ	名詞
ｻﾄﾞｳｴｷ	作動液	名詞
ｻﾄﾞｳﾊｲｷ	差動排気	名詞
ｻﾄﾞｳﾍﾝｱﾂｷ	差動変圧器	名詞
ｻﾄﾞｳﾎｳ	差動法	名詞
ｻﾄﾞｳｷｮﾘ	作動距離	名詞
ｻﾄﾞｳﾈﾂﾘｮｳｿｸﾃｲ	差動熱量測定	名詞
ｻﾄﾞｳｿﾞｳﾌｸｷ	差動増幅器	名詞
ｻｰﾌｫﾝ	サーフォン	名詞
ｻｷﾞｮｳﾌﾞｯｼﾂ	作業物質	名詞
ｻｷﾞｮｳｶｾﾂ	作業仮説	名詞
ｻﾊﾉﾃﾞﾝﾘﾛﾝ	サハの電離論	名詞
ｻｲﾊﾞﾈﾃｨｸｽ	サイバネティクス	名詞
ｻｲﾎﾞｳﾓｹｲﾘﾛﾝ	細胞模型理論	名詞
ｻｲﾀﾞｲｷｼﾞｭﾝｼﾝﾄﾞｳ	最大基準振動	名詞
ｻｲﾀﾞｲﾏｻﾂﾘｮｸ	最大摩擦力	名詞
ｻｲﾀﾞｲｼｺﾞﾄﾉｹﾞﾝﾘ	最大仕事の原理	名詞
ｻｲﾊｲﾚﾂ	再配列	名詞
ｻｲｶｲｾﾂﾎｳ	再回折法	名詞
ｻｲｶｸﾁ	最確値	名詞
ｻｲｶﾝﾈﾝﾄﾞｹｲ	細管粘度計	名詞
ｻｲｹﾂｺﾞｳﾊｯｺｳ	再結合発光	名詞
ｻｲｹﾂｺﾞｳｹｲｽｳ	再結合係数	名詞
ｻｲｹﾂｺﾞｳﾚﾝｿﾞｸ	再結合連続	連体詞
ｻｲｹﾂｺﾞｳｾﾝ	再結合線	名詞
ｻｲｷｹﾞﾝｼｮｳ	再帰現象	名詞
ｻｲｷﾊﾝｼｬ	再帰反射	名詞
ｻｲｷｾｲ	再帰性	名詞
ｻｲｷﾃｷ	再帰的	連体詞
ｻｲｺｳｷｭｳﾆｭｳｱﾂ	最高吸入圧	名詞
ｻｲｺｳｻｲﾃｲｵﾝﾄﾞｹｲ	最高最低温度計	名詞
ｻｲｺｳｾﾝﾉｼﾞｯｹﾝ	細孔栓の実験	名詞
ｻｲｸﾛｲﾄﾞｶﾞﾀ	サイクロイド型	連体詞
ｼﾂﾘｮｳﾌﾞﾝｾｷｹｲ	質量分析計	名詞
ｻｲｸﾛｲﾄﾞﾌﾘｺ	サイクロイド振り子	名詞
ｻｲｸﾛﾄﾛﾝ	サイクロトロン	名詞
ｻｲｸﾛﾄﾛﾝｴｺｰ	サイクロトロンエコー	名詞
ｻｲｸﾛﾄﾛﾝｹﾞﾝｽｲ	サイクロトロン減衰	名詞
ｻｲｸﾛﾄﾛﾝﾎｳｼｬ	サイクロトロン放射	名詞
ｻｲｸﾛﾄﾛﾝｷｮｳﾒｲ	サイクロトロン共鳴	名詞
ｻｲｸﾛﾄﾛﾝｼﾝﾄﾞｳｽｳ	サイクロトロン振動数	名詞
ｻｲｸﾛﾄﾛﾝｳﾝﾄﾞｳ	サイクロトロン運動	名詞
ｻｲｷｭｳｺｳｶﾎｳ	最急降下法	名詞
ｻｲﾐﾂｺｳｼ	最密格子	名詞
ｻｲﾐﾂｺｳｿﾞｳ	最密構造	名詞
ｻｲﾐﾂﾒﾝ	最密面	名詞
ｻｲﾐﾂﾁｮｳｾｲ	細密調整	名詞
ｻｲﾝｺﾞﾙﾄﾞﾝﾎｳﾃｲｼｷ	サインゴルドン方程式	名詞
ｻｲﾗﾄﾛﾝ	サイラトロン	名詞
ｻｲﾘｽﾀｰ	サイリスター	名詞
ｻｲｻｳﾝﾄﾞｳ	歳差運動	名詞
ｻｲｾｲｹﾝﾊﾟ	再生検波	名詞
ｻｲｾｲｿﾞｳ	再生像	名詞
ｻｲｿｳ	彩層	名詞
ｻｲｿｸｺｳｶｾﾝ	最速降下線	名詞
ｻｲｼｮｳﾃﾞﾝﾘｿﾝｼﾂ	最小電離損失	名詞
ｻｲｼｮｳﾍﾝｶｸ	最小偏角	名詞
ｻｲｼｮｳｶﾓﾝﾀﾞｲ	最小化問題	名詞
ｻｲｼｮｳｶﾁｮｳﾁ	最小可聴値	名詞
ｻｲｼｮｳｷｮｸﾘﾂﾉｹﾞﾝﾘ	最小曲率の原理	名詞
ｻｲｼｮｳﾆｼﾞｮｳﾎｳ	最小二乗法	名詞
ｻｲｼｮｳｻﾖｳﾉｹﾞﾝﾘ	最小作用の原理	名詞
ｻｲｼｮｳｼｺﾞﾄ	最小仕事	名詞
ｻｲｼｮｳｿｸﾊﾞｸﾉｹﾞﾝﾘ	最小束縛の原理	名詞
ｻｲｼｮｳｼｭｳﾘｮｳ	最少収量	名詞
ｻｲﾃｷｾｲｷﾞｮ	最適制御	名詞
ｻｲﾕｳﾎｳ	最優法	名詞
ｻｲｼﾞﾝｹｲ	細塵計	名詞
ｻｶﾀﾓｹｲ	坂田模型	名詞
ｻｸｲｵﾝ	錯イオン	名詞
ｻｸｼ	錯視	名詞
ｻｸｿﾝﾊｯﾄﾅｰﾉﾃｲﾘ	サクソン・ハットナーの定理	名詞
ｻｸｿﾝｳｯｽﾞﾎﾟﾃﾝｼｬﾙ	サクソン・ウッズポテンシャル	名詞
ｻｰｷｭﾚｰﾀｰ	サーキュレーター	名詞
ｻｰﾏﾙｺﾗﾑ	サーマルコラム	名詞
ｻｰﾐｽﾀｰ	サーミスター	名詞
ｻｰﾓｶﾗｰ	サーモカラー	名詞
ｻｰﾓｸﾛﾐｽﾞﾑ	サーモクロミズム	名詞
ｻｰﾓﾄﾛﾋﾟｯｸｴｷｼｮｳ	サーモトロピック液晶	名詞
ｻﾝｱﾗｲ	酸洗い	名詞
ｻﾝﾀﾞﾝｺｳｶ	散弾効果	名詞
ｻﾝﾀﾞﾝｻﾞﾂｵﾝ	散弾雑音	名詞
ｻﾝｹﾞﾝｼﾌﾞﾝｼ	三原子分子	名詞
ｻﾝｲﾂｶﾝｽｳ	散逸関数	名詞
ｻﾝｲﾂｹｲ	散逸系	名詞
ｻﾝｲﾂｺｳｿﾞｳ	散逸構造	名詞
ｻﾝｶﾎﾞｳｼｻﾞｲ	酸化防止剤	名詞
ｻﾝｶﾌﾞﾂｲﾝｷｮｸ	酸化物陰極	名詞
ｻﾝｶｴﾝ	酸化炎	名詞
ｻﾝｶｶﾝｹﾞﾝﾃﾞﾝｲ	酸化還元電位	名詞
ｻﾝｶｸﾎｼｶﾞﾀﾍﾝｶﾝ	三角-星形変換	名詞
ｻﾝｶｸｹｲｲｼﾞｮｳ	三角形異常	名詞
ｻﾝｶｯｹｲｲｼﾞｮｳ	三角形異常	名詞
ｻﾝｶｸｼﾞｷｺｳｿﾞｳ	三角磁気構造	名詞
ｻﾝｶｽｳ	酸化数	名詞
ｻﾝｷ	酸基	名詞
ｻﾝｺｳｾｲｳﾝ	散光星雲	名詞
ｻﾝｷｮｸｶﾝ	三極管	名詞
ｻﾝﾏﾝｻﾝﾗﾝ	散漫散乱	名詞
ｻﾝﾎﾟｳｼｮｳｹｲ	三方晶系	名詞
ｻﾝﾌﾟﾘﾝｸﾞｵｼﾛｽｺｰﾌﾟ	サンプリングオシロスコープ	名詞
ｻﾝﾌﾟﾘﾝｸﾞﾃｲﾘ	サンプリング定理	名詞
ｻﾝﾌﾟﾙﾎｰﾙﾄﾞｶｲﾛ	サンプルホールド回路	名詞
ｻﾝﾌﾟﾙﾁｾｲｷﾞｮ	サンプル値制御	名詞
ｻﾝﾗﾝﾍﾞｸﾄﾙ	散乱ベクトル	名詞
ｻﾝﾗﾝﾀﾞﾝﾒﾝｾｷ	散乱断面積	名詞
ｻﾝﾗﾝｴﾝｻﾞﾝｼ	散乱演算子	名詞
ｻﾝﾗﾝｷﾞｮｳﾚﾂ	散乱行列	名詞
ｻﾝﾗﾝﾊ	散乱波	名詞
ｻﾝﾗﾝｹｲ	散乱径	名詞
ｻﾝﾗﾝﾊﾝｹｲ	散乱半径	名詞
ｻﾝﾗﾝｲﾝｼ	散乱因子	名詞
ｻﾝﾗﾝｶｸ	散乱角	名詞
ｻﾝﾗﾝﾘﾛﾝ	散乱理論	名詞
ｻﾝﾗﾝｼﾝﾌﾟｸ	散乱振幅	名詞
ｻﾝﾗﾝｿｳ	散乱槽	名詞
ｻﾝﾗﾝﾀｲ	散乱体	名詞
ｻﾝﾗﾝﾁｮｳ	散乱長	名詞
ｻﾝｿｺｳｶﾋ	酸素効果比	名詞
ｻﾝｼｬｼｮｳｹｲ	三斜晶系	名詞
ｻﾝｼｮｳﾃﾞﾝｷｮｸ	参照電極	名詞
ｻﾝｼｮｳﾊ	参照波	名詞
ｻﾝﾀｲﾓﾝﾀﾞｲ	三体問題	名詞
ｻﾝﾀｲﾘｮｸ	三体力	名詞
ｻﾝｼﾞｹﾞﾝﾎﾛｸﾞﾗﾑ	三次元ホログラム	名詞
ｻﾝｼﾞｺｳｿﾞｳ	三次構造	名詞
ｻﾝｼﾞｸﾋｽﾞﾐ	三軸ひずみ	名詞
ｻﾝｼﾞｸｶｲﾃﾝｼﾓｹｲ	三軸回転子模型	名詞
ｻﾝｼﾞｭｳｹﾂｺﾞｳ	三重結合	名詞
ｻﾝｼﾞｭｳｺｳ	三重項	名詞
ｻﾝｼﾞｭｳｺｳｼﾞｮｳﾀｲ	三重項状態	名詞
ｻﾝｼﾞｭﾝｲﾒｰｻﾞｰ	三準位メーザー	名詞
ｻﾝｼﾞｭｳﾘﾝｶｲﾃﾝ	三重臨界点	名詞
ｻﾝｼﾞｭｳｾﾝ	三重線	名詞
ｻﾝｼﾞｭｳｽｲｿ	三重水素	名詞
ｻﾝｼﾞｭｳﾃﾝ	三重点	名詞
ｻﾝｼﾞｭｳﾖｳｼ	三重陽子	名詞
ｻﾌﾟﾗｲｻﾞﾙｶｲｾｷ	サプライザル解析	名詞
ｻﾌﾟﾚｯｻｰｹﾞｰｼﾞ	サプレッサーゲージ	名詞
ｻｾﾌﾟﾀﾝｽ	サセプタンス	名詞
ｻｼｭｳﾊﾊｯｾｲ	差周波発生	名詞
ｻﾖｳﾊﾝｻﾖｳﾉﾎｳｿｸ	作用反作用の法則	名詞
ｻﾖｳﾍﾝｽｳ	作用変数	名詞
ｻﾖｳﾘｮｳｾｷﾌﾞﾝ	作用量積分	名詞
ｻﾖｳﾘｮｳｼ	作用量子	名詞
ｻﾖｳｾﾝ	作用線	名詞
ｻﾖｳｾｷﾌﾞﾝ	作用積分	名詞
ｻﾖｳｿ	作用素	名詞
ｻﾖｳｽﾍﾟｸﾄﾙ	作用スペクトル	名詞
ｻﾖｳﾃﾝ	作用点	名詞
ｻｼﾞﾀﾙｺｳｾﾝ	サジタル光線	名詞
ｾｸﾞﾒﾝﾄ	セグメント	名詞
ｾｲｱﾂ	静圧	名詞
ｾｲｱﾂｶﾝ	静圧管	名詞
ｾｲｱﾂﾘｮｸ	静圧力	名詞
ｾｲﾌﾞﾂﾌﾞﾂﾘｶﾞｸ	生物物理学	名詞
ｾｲﾌﾞﾂｶﾞｸﾃｷﾊﾝｹﾞﾝｷ	生物学的半減期	名詞
ｾｲﾌﾞﾂｶﾞｸﾃｷ	生物学的	連体詞
ｾｲﾌﾞﾂｶﾞｸﾃｷｺｳｶﾋ	生物学的効果比	名詞
ｾﾝﾘｮｳｿｸﾃｲ	線量測定	名詞
ｾｲﾌﾞﾂﾊｯｺｳ	生物発光	名詞
ｾｲﾌﾞﾂｶｶﾞｸﾃｷｾﾝｻｰ	生物化学的センサー	名詞
ｾｲﾃﾞﾝﾊﾞ	静電場	名詞
ｾｲﾃﾞﾝｴﾈﾙｷﾞｰ	静電エネルギー	名詞
ｾｲﾃﾞﾝｶﾞﾀ	静電型	連体詞
ｾｲﾃﾞﾝﾊ	静電波	名詞
ｾｲﾃﾞﾝﾍﾝｺｳ	静電偏向	名詞
ｾｲﾃﾞﾝｶ	正電荷	名詞
ｾｲﾃﾞﾝｶｲ	静電界	名詞
ｾｲﾃﾞﾝｶｿｸｷ	静電加速器	名詞
ｾｲﾃﾞﾝｷｶﾞｸ	静電気学	名詞
ｾｲﾃﾞﾝｷﾛｸ	静電記録	名詞
ｾｲﾃﾞﾝﾎﾟﾃﾝｼｬﾙ	静電ポテンシャル	名詞
ｾｲﾃﾞﾝﾚﾝｽﾞ	静電レンズ	名詞
ｾｲﾃﾞﾝｾﾌﾟﾀﾑ	静電セプタム	名詞
ｾｲﾃﾞﾝｽﾍﾟｸﾄﾛﾒｰﾀｰ	静電スペクトロメーター	名詞
ｾｲﾃﾞﾝｼｬﾍｲ	静電遮蔽	名詞
ｾｲﾃﾞﾝｼｭｳｿｸ	静電集束	名詞
ｾｲﾃﾞﾝﾀﾝｲｹｲ	静電単位系	名詞
ｾｲﾃﾞﾝﾀﾝｼﾝ	静電探針	名詞
ｾｲﾃﾞﾝﾖｳﾘｮｳ	静電容量	名詞
ｾｲﾃﾞﾝﾕｳﾄﾞｳ	静電誘導	名詞
ｾｲﾃﾞﾝﾕｳｿｳｹｲｽｳ	静電誘導係数	名詞
ｾｲﾃﾞﾝﾕｳﾄﾞｳ	静電誘導	連体詞
ｾｲﾄﾞｳﾎｳｼｬ	制動放射	名詞
ｾｲﾄﾞｳXｾﾝ	制動X線	名詞
ｾｲｹﾞﾝﾊ	正弦波	名詞
ｾｲｹﾞﾝｼﾔｶｲｾﾂ	制限視野回折	名詞
ｾｲｹﾞﾝｼﾞｮｳｹﾝ	正弦条件	名詞
ｾｲｺﾞｳﾊﾝｼｬ	整合反射	名詞
ｾｲｺﾞｳﾍﾝｾｲｷ	整合変成器	名詞
ｾｲｺﾞｳﾋｾｲｺﾞｳﾃﾝｲ	整合-非整合転移	名詞
ｾｲｺﾞｳﾌｾｲｺﾞｳﾃﾝｲ	整合-不整合転移	名詞
ｾｲｺﾞｳｺｳｿﾞｳ	整合構造	名詞
ｾｲﾊﾝｼｬ	正反射	名詞
ｾｲﾋﾛｳ	静疲労	名詞
ｾｲﾎｳﾍﾝｲ	青方偏移	名詞
ｾｲﾎｳｼｮｳｹｲ	正方晶系	名詞
ｾｲｲｵﾝ	正イオン	名詞
ｾｲｶﾝﾌﾞﾝｼ	星間分子	名詞
ｾｲｶﾝｶﾞｽ	星間ガス	名詞
ｾｲｶﾝﾌﾞｯｼﾂ	星間物質	名詞
ｾｲｶﾝｸｳｶﾝ	星間空間	名詞
ｾｲｶﾝｷｭｳｼｭｳ	星間吸収	名詞
ｾｲｶﾝｾｷｶ	星間赤化	名詞
ｾｲｶﾝｳﾝ	星間雲	名詞
ｾｲｶﾝｼﾞﾊﾞ	星間磁場	名詞
ｾｲｶﾝｼﾞﾝ	星間塵	名詞
ｾｲｹｯｼｮｳ	正結晶	名詞
ｾｲｷﾌﾞﾌﾞﾝｸﾞﾝ	正規部分群	名詞
ｾｲｷﾌﾞﾝﾌﾟ	正規分布	名詞
ｾｲｷｸﾞﾛｰﾎｳﾃﾞﾝ	正規グロー放電	名詞
ｾｲｷﾎｳﾃｲｼｷ	正規方程式	名詞
ｾｲｷｶﾝ	正帰還	名詞
ｾｲｷﾓｰﾄﾞ	正規モード	名詞
ｾｲｷﾁｮｯｺｳｾｲ	正規直交性	名詞
ｾｲｷｻﾞﾋｮｳ	正規座標	名詞
ｾｲｷｼﾞｭｳﾘｮｸ	正規重力	名詞
ｾｲｺｳ	正孔	名詞
ｾｲｺﾛﾅ	正コロナ	名詞
ｾｲﾏｻﾂ	静摩擦	名詞
ｾｲﾉｳｼｽｳ	性能指数	名詞
ｾｲﾚﾂﾄﾞｹﾞﾝｼｮｳ	整列度減少	名詞
ｾｲﾚﾂﾄﾞﾉｹﾞﾝｼｮｳ	整列度の減少	名詞
ｾｲﾘｷｶﾞｸ	静力学	名詞
ｾｲﾘｭｳ	精留	名詞
ｾｲﾘｭｳｹﾝﾘｭｳｹｲ	整流検流計	名詞
ｾｲﾘｭｳｶﾞﾀｹﾝﾘｭｳｹｲ	整流型検流計	名詞
ｾｲﾘｭｳｶｲﾛ	整流回路	名詞
ｾｲﾘｭｳｶﾝ	整流管	名詞
ｾｲﾘｭｳｷ	整流器	名詞
ｾｲﾘｭｳｼ	整流子	名詞
ｾｲｾｲｴﾝｻﾞﾝｼ	生成演算子	名詞
ｾｲｾｲﾈﾂ	生成熱	名詞
ｾｲｾｲｼｮｳﾒﾂｴﾝｻﾞﾝｼ	生成・消滅演算子	名詞
ｾｲｾｲｻﾞﾋｮｳﾎｳ	生成座標法	名詞
ｾｲｾｷｹｲｽｳ	成績係数	名詞
ｾｲｼﾃﾞﾝｱﾂ	静止電圧	名詞
ｾｲｼﾃﾞﾝｲ	静止電位	名詞
ｾｲｼｴｲｾｲ	静止衛星	名詞
ｾｲｼｴﾈﾙｷﾞｰ	静止エネルギー	名詞
ｾｲｼｹｲ	静止系	名詞
ｾｲｼﾏｻﾂ	静止摩擦	名詞
ｾｲｼﾏｻﾂｹｲｽｳ	静止摩擦係数	名詞
ｾｲｼﾒﾝﾀｲﾌﾞﾝｼ	正四面体分子	名詞
ｾｲｼﾘｭｳﾀｲ	静止流体	名詞
ｾｲｼｼﾂﾘｮｳ	静止質量	名詞
ｾｲｼｻﾞﾋｮｳｹｲ	静止座標系	名詞
ｾｲｿｸｶ	正則化	名詞
ｾｲｿｸｶﾎｳ	正則化法	名詞
ｾｲｿｸｶﾝｽｳ	正則関数	名詞
ｾｲｿｳﾘｭｳﾀｲ	成層流体	名詞
ｾｲｽｲｱﾂ	静水圧	名詞
ｾｲｽｳｷｮｳﾒｲ	整数共鳴	名詞
ｾｲﾀｲﾎｳｼｬｾﾝｺｳｶ	生体放射線効果	名詞
ｾｲﾀｲｺｳﾌﾞﾝｼ	生体高分子	名詞
ｾｲﾃｲ	静定	連体詞
ｾｲﾃｲｼﾞｶﾝ	整定時間	名詞
ｾｲﾃｷｳﾁｭｳ	静的宇宙	名詞
ｾｲﾁｮｳｷｮｸｾﾝ	成長曲線	名詞
ｾｲﾁｮｳｾﾂｺﾞｳ	成長接合	連体詞
ｾｲﾁｮｳｽﾊﾟｲﾗﾙ	成長スパイラル	名詞
ｾｲｳﾝｾﾝ	星雲線	名詞
ｾｲﾔｰﾉｼｷ	セイヤーの式	名詞
ｾｲｼﾞﾊﾞ	静磁場	名詞
ｾｲｼﾞｷｶﾞｸ	静磁気学	名詞
ｾｲｼﾞﾓｰﾄﾞ	静磁モード	名詞
ｾｲｼﾞｮｳﾌﾞﾝｻﾝ	正常分散	名詞
ｾｲｼﾞｮｳｴｷﾀｲ	正常液体	名詞
ｾｲｼﾞｮｳﾊ	正常波	名詞
ｾｲｼﾞｮｳﾋｮｳﾒﾝ	清浄表面	名詞
ｾｲｼﾞｮｳｹｲﾚﾂ	正常系列	名詞
ｾｲｼﾞｮｳｺｳ	正常項	名詞
ｾｲｼﾞｮｳｽｲｿ	正常水素	名詞
ｾｲｼﾞｮｳｾﾞｰﾏﾝｺｳｶ	正常ゼーマン効果	名詞
ｾｲｼﾞｭﾝﾌﾞﾝﾌﾟ	正準分布	名詞
ｾｲｼﾞｭﾝﾍﾝｶﾝ	正準変換	名詞
ｾｲｼﾞｭﾝﾍﾝｽｳ	正準変数	名詞
ｾｲｼﾞｭﾝﾎｳﾃｲｼｷ	正準方程式	名詞
ｾｲｼﾞｭﾝｺｳｶﾝｶﾝｹｲ	正準交換関係	名詞
ｾｲｼﾞｭﾝﾘｮｳｼｶ	正準量子化	名詞
ｾｲｼﾞｭﾝｼｭｳﾀﾞﾝ	正準集団	名詞
ｾｶｲﾒﾝ	世界面	名詞
ｾｶｲｾﾝ	世界線	名詞
ｾｶﾝﾄﾎｳ	セカント法	名詞
ｾｷﾌﾞﾝﾊﾝｼｬｷｮｳﾄﾞ	積分反射強度	名詞
ｾｲｷﾌﾞﾝﾊﾝｼｬﾉｳ	積分反射能	名詞
ｾｷﾌﾞﾝﾍﾝｶﾝ	積分変換	名詞
ｾｷﾌﾞﾝｶｲﾛ	積分回路	名詞
ｾｷﾌﾞﾝｷｮｳﾄﾞ	積分強度	名詞
ｾｷﾌﾞﾝｷｭｳ	積分球	名詞
ｾｷﾌﾞﾝｾﾝﾘｮｳ	積分線量	名詞
ｾｷﾄﾞｳｷﾞ	赤道儀	名詞
ｾｷﾄﾞｳｺｳｶﾞﾀﾓｹｲ	赤銅鉱型模型	名詞
ｾｷｶﾞｲﾌﾞﾝｺｳｺｳﾄﾞｹｲ	赤外分光光度計	名詞
ｾｷｶﾞｲﾊｯｻﾝ	赤外発散	名詞
ｾｷｶﾞｲﾎｳｼｬ	赤外放射	名詞
ｾｷｶﾞｲｶｯｾｲ	赤外活性	連体詞
ｾｷｶﾞｲｷｭｳｼｭｳ	赤外吸収	連体詞
ｾｷｶﾞｲﾚｰｻﾞｰ	赤外レーザー	名詞
ｾｷｶﾞｲｾﾝｹﾝﾋﾞｷｮｳ	赤外線顕微鏡	名詞
ｾｷｶﾞｲｾﾝｹﾝｼｭﾂｷ	赤外線検出器	名詞
ｾｷｶﾞｲｾﾝｼｮｳｼｬ	赤外線照射	名詞
ｾｷｶﾞｲｾﾝﾃﾝﾓﾝｶﾞｸ	赤外線天文学	名詞
ｾｷｶﾞｲｽﾍﾟｸﾄﾙ	赤外スペクトル	名詞
ｾｷﾎｳﾍﾝｲ	赤方偏移	名詞
ｾｷｲ	赤緯	名詞
ｾｷｿｳﾃﾞﾝﾁ	積層電池	名詞
ｾｷｿｳｹｯｶﾝｼﾒﾝﾀｲ	積層欠陥四面体	名詞
ｾｷｼｮｸｷｮｾｲ	赤色巨星	名詞
ｾｷｼｭﾂｺｳｶ	析出硬化	名詞
ｾｯｹｲ	赤経	名詞
ｾｯｹｲｵｳﾘｮｸ	設計応力	名詞
ｾｸﾀｰﾎｳ	セクター法	名詞
ｾｸﾀｰｼｭｳｿｸｶﾞﾀ	セクター収束型	連体詞
ｾﾐﾚﾌﾟﾄﾝﾎｳｶｲ	セミレプトン崩壊	名詞
ｾﾐﾁｬﾈﾘﾝｸﾞ	セミチャネリング	名詞
ｾﾝｱｴﾝｺｳｶﾞﾀｺｳｿﾞｳ	閃亜鉛鉱型構造	名詞
ｾﾅﾙﾓﾝﾉﾎｼｮｳﾊﾞﾝ	セナルモンの補償板	名詞
ｾﾝﾎﾞｳﾁｮｳｹｲｽｳ	線膨張係数	名詞
ｾﾝﾀﾞﾝ	せん断	名詞
ｾﾝﾀﾞﾝﾀﾞﾝｾｲｹｲｽｳ	せん断弾性係数	名詞
ｾﾝﾀﾞﾝﾋｽﾞﾐ	せん断ひずみ	名詞
ｾﾝﾀﾞﾝｵｳﾘｮｸ	せん断応力	名詞
ｾﾝﾀﾞﾝﾘｭｳ	せん断流	名詞
ｾﾝｴｲﾄﾞ	鮮鋭度	名詞
ｾﾝｴｲｶ	尖鋭化	名詞
ｾﾝｴｲｶ	せん鋭化	名詞
ｾﾝｴﾈﾙｷﾞｰﾌﾖ	線エネルギー付与	名詞
ｾﾝｹﾞﾝ	線源	名詞
ｾﾝｲｹﾞﾝｿ	遷移元素	名詞
ｾﾝｲｷﾞｮｳﾚﾂ	遷移行列	名詞
ｾﾝｲﾎｳｼｬ	遷移放射	名詞
ｾﾝｲｶｸﾘﾂ	遷移確率	名詞
ｾﾝｲｹｲｼﾞｮｳｲﾝｼ	遷移形状因子	名詞
ｾﾝｲｷﾝｿﾞｸ	遷移金属	名詞
ｾﾝｲｺｳｶﾞｸ	繊維光学	名詞
ｾﾝｲﾓｰﾒﾝﾄ	遷移モーメント	名詞
ｾﾆｵﾘﾃｨｽｳ	セニオリティ数	名詞
ｾﾝｲﾘｮｳｲｷ	遷移領域	名詞
ｾﾝｲｼﾝﾄﾞｳｽｳ	遷移振動数	名詞
ｾﾝｲｼﾝﾌﾟｸ	遷移振幅	名詞
ｾﾝｲｼｭｳｷ	遷移周期	名詞
ｾﾝｲｼﾞｮｳﾀｲ	遷移状態	名詞
ｾﾝｶｲﾊﾝｹｲ	旋回半径	名詞
ｾﾝｶｲｷﾄﾞｳｼｮｳﾄﾂ	旋回軌道衝突	名詞
ｾﾝｹｲﾄﾞｸﾘﾂ	線形独立	名詞
ｾﾝｹｲｴﾝｻﾞﾝｼ	線形演算子	名詞
ｾﾝｹｲｹﾞｰﾄ	線形ゲート	名詞
ｾﾝｹｲﾌｸｹﾞﾝﾘｮｸ	線形復元力	名詞
ｾﾝｹｲｶ	線形化	名詞
ｾﾝｹｲｶｲﾛ	線形回路	名詞
ｾﾝｹｲｶｿｸｷ	線形加速器	名詞
ｾﾝｹｲｸｳｶﾝ	線形空間	名詞
ｾﾝｹｲﾈﾝﾀﾞﾝｾｲ	線形粘弾性	名詞
ｾﾝｹｲｵｳﾄｳﾘﾛﾝ	線形応答理論	名詞
ｾﾝｹｲｻﾖｳｿ	線形作用素	名詞
ｾﾝｹｲｿｼ	線形素子	名詞
ｾﾝｹｲﾖｿｸ	線形予測	名詞
ｾﾝｹｲﾖｿｸｹｲｽｳ	線形予測係数	名詞
ｾﾝｹｲｿﾞｳﾌｸｶﾝ	線形増幅管	名詞
ｾﾝｹｲｼﾞｭｳｿﾞｸ	線形従属	名詞
ｾﾝｺｳ	旋光	名詞
ｾﾝｺｳﾌﾞﾝｻﾝ	旋光分散	名詞
ｾﾝｺｳﾄﾞ	旋光度	名詞
ｾﾝｺｳｹｲ	旋光計	名詞
ｾﾝｺｳｺｳﾌﾞﾝｶｲ	閃光光分解	名詞
ｾﾝｺｳﾉｳ	旋光能	名詞
ｾﾝｺｳｼ	旋光子	名詞
ｾﾝｺｳｽﾍﾟｸﾄﾙ	閃光スペクトル	名詞
ｾﾝｸｼﾞｮｳﾀｲ	先駆状態	名詞
ｾﾝｷｭｳｼｭｳｹｲｽｳ	線吸収係数	名詞
ｾﾝﾐﾂﾄﾞ	線密度	名詞
ｾﾝｵﾝｿｸ	遷音速	名詞
ｾﾝﾘｮｳ	線量	名詞
ｾﾝﾘｮｳﾊﾝﾉｳｿｳｶﾝ	線量反応相関	名詞
ｾﾝﾘｮｳｹｲ	線量計	名詞
ｾﾝﾘｮｳﾘﾂ	線量率	名詞
ｾﾝﾘｮｳﾄｳﾘｮｳ	線量当量	名詞
ｾﾝﾘｮｳﾖﾀｸ	線量預託	名詞
ｾﾝｾｷﾌﾞﾝ	線積分	名詞
ｾﾝｼﾝｸﾞﾘｰﾝｶﾝｽｳ	先進グリーン関数	名詞
ｾﾝｼﾄﾒﾄﾘｰ	センシトメトリー	名詞
ｾﾝｼﾂｹｲｽｳ	線質係数	名詞
ｾﾝｼﾂｺｳｶ	線質効果	名詞
ｾﾝｿｸﾄﾞ	線速度	名詞
ｾﾝｽｲﾊ	浅水波	名詞
ｾﾝｽﾍﾟｸﾄﾙ	線スペクトル	名詞
ｾﾝｼｮｸｺｳｶ	浅色効果	名詞
ｾﾝﾀｸﾊｲｷ	選択排気	名詞
ｾﾝﾀｸﾊﾝｼｬ	選択反射	名詞
ｾﾝﾀｸﾎｳｲ	選択方位	名詞
ｾﾝﾀｸｿｸ	選択則	名詞
ｾﾝﾀｸｷｿｸ	選択規則	名詞
ｾﾝﾀｸｷｭｳｼｭｳ	選択吸収	名詞
ｾﾝﾀｸﾚｲｷ	選択励起	名詞
ｾﾝﾀｸｾｲﾁｮｳ	選択成長	名詞
ｾﾝﾀﾝﾎｳﾃﾞﾝ	先端放電	名詞
ｾﾝﾀﾝｿｸﾄﾞ	先端速度	名詞
ｾﾝﾄﾗﾙﾓｰﾄﾞ	セントラルモード	名詞
ｾﾝﾄﾗﾙﾋﾟｰｸ	セントラルピーク	名詞
ｾﾝﾕｳﾃﾞﾝｼｽｳｶｲｾｷ	占有電子数解析	名詞
ｾﾝﾕｳｽｳ	占有数	名詞
ｾﾝｿﾞｳ	潜像	名詞
ｾﾝｽﾞ	線図	名詞
ｾﾝｼﾞｮｳｺｳﾌﾞﾝｼ	線状高分子小
ｾﾊﾟﾗﾄﾘｯｸｽ	セパラトリックス	名詞
ｾﾌﾟﾀﾑﾃﾞﾝｼﾞｼｬｸ	セプタム電磁石	名詞
ｾﾗﾐｯｸﾌｨﾙﾀｰ	セラミックフィルター	名詞
ｾﾗﾐｯｸﾊｯｼﾝｷ	セラミック発振器	名詞
ｾﾗﾐｯｸﾈﾝﾘｮｳ	セラミック燃料	名詞
ｾﾚﾝｾｲﾘｭｳｷ	セレン整流器	名詞
ｾﾙｺｳｿﾞｳ	セル構造	名詞
ｾﾙﾏｲﾔｰﾉﾌﾞﾝｻﾝｼｷ	セルマイヤーの分散式	名詞
ｾﾙｼﾝﾓｰﾀｰ	セルシンモーター	名詞
ｾｼﾄﾞ	セ氏度	名詞
ｾｯｾﾝ	節線	名詞
ｾｯｾﾝｶｿｸﾄﾞ	接線加速度	名詞
ｾｯｾﾝｵｳﾘｮｸ	接線応力	名詞
ｾｯｾﾝﾘｮｸ	接線力	名詞
ｾｯｼｮｸﾃﾞﾝｲｻ	接触電位差	名詞
ｾｯｼｮｸﾃﾞﾝｷ	接触電気	名詞
ｾｯｼｮｸﾃﾞﾝﾘ	接触電離	名詞
ｾｯｼｮｸﾍﾝｶﾝ	接触変換	名詞
ｾｯｼｮｸｶｸ	接触角	名詞
ｾｯｼｮｸﾓﾝﾀﾞｲ	接触問題	名詞
ｾｯｼｮｸﾃｲｺｳ	接触抵抗	名詞
ｾｯﾃﾝﾃｲｺｳｹｲ	接点抵抗計	名詞
ｾｯﾁﾃｲｺｳ	接地抵抗	名詞
ｾｯﾁﾃｲｺｳｹｲ	接地抵抗計	名詞
ｾﾂﾄﾞｳ	摂動	名詞
ｾﾂﾄﾞｳﾛﾝ	摂動論	名詞
ｾﾂｶﾞﾝｷｮｳ	接眼鏡	名詞
ｾﾂｶﾞﾝﾏｲｸﾛﾒｰﾀｰ	接眼マイクロメーター	名詞
ｾﾂｶﾞﾝﾚﾝｽﾞ	接眼レンズ	名詞
ｾﾂｺﾞｳｹﾞｰﾄ	接合ゲート	連体詞
ﾃﾞﾝｶｲｺｳｶ	電界効果	連体詞
ｾﾂｺﾞｳﾚｰｻﾞｰ	接合レーザー	名詞
ｾﾂｺﾞｳﾄﾗﾝｼﾞｽﾀｰ	接合トランジスター	名詞
ｾﾂﾍｲﾒﾝ	節平面	名詞
ｾﾂｿﾞｸｷﾞｮｳﾚﾂ	接続行列	名詞
ｾﾔﾅﾐｵｶﾓﾉｸﾛﾒｰﾀｰ	瀬谷・波岡モノクロメーター	名詞
ｼﾄﾞ	視度	名詞
ｼｶﾞｲﾊｯｻﾝ	紫外発散	名詞
ｼｶﾞｲﾎｳｼｬ	紫外放射	名詞
ｼｶﾞｲｹﾝｼｭﾂｷ	紫外検出器	名詞
ｼｶﾞｲｺｳﾃﾞﾝｼ	紫外光電子	名詞
ｼｶﾞｲｺｳｹﾞﾝ	紫外光源	名詞
ｼｶﾞｲﾚｰｻﾞｰ	紫外レーザー	名詞
ｼｶﾞｲｾﾝｹﾝﾋﾞｷｮｳ	紫外線顕微鏡	名詞
ｼｶﾞｲｽﾍﾟｸﾄﾙ	紫外スペクトル	名詞
ｼｺﾞﾒﾝ	子午面	名詞
ｼｺﾞﾄｶﾝｽｳ	仕事関数	名詞
ｼｺﾞﾄﾉｹﾞﾝﾘ	仕事の原理	名詞
ｼｸﾞﾑﾝﾄﾉﾘﾛﾝ	シグムントの理論	名詞
ｼｰﾄﾓｹｲ	シート模型	名詞
ｼｶﾝﾄﾞ	視感度	名詞
ｼｶﾝｿｯｺｳ	視感測光	名詞
ｼｷﾍﾞﾂｶﾝｽｳ	識別関数	名詞
ｼｷﾄﾞ	色度	名詞
ｼｷﾄﾞｽﾞ	色度図	名詞
ｼｷﾋｮｳ	色票	名詞
ｼｷｲｹﾝｼｭﾂｷ	しきい検出器	名詞
ｼｷｲｾﾝﾘｮｳ	しきい線量	名詞
ｼｷｲﾁｴﾈﾙｷﾞｰ	しきい値エネルギー	名詞
ｼｷｲﾁﾘﾛﾝ	しきい値理論	名詞
ｼｷｲｼﾞｮｳｹﾝ	しきい条件	名詞
ｼｷｿﾚｰｻﾞｰ	色素レーザー	名詞
ｼｯｶﾂ	失活	名詞
ｼｺｳｹｲｽｳ	指向係数	名詞
ｼｺｳｻｸｺﾞﾎｳ	試行錯誤法	名詞
ｼｺｳｾｲﾘﾄｸ	指向性利得	名詞
ｼｺｳｼｽｳ	指向指数	名詞
ｼｺｳｼﾞｯｹﾝ	思考実験	名詞
ｼｷｬｸﾊﾞ	四脚場	名詞
ｼｷｮｳﾍﾝｽｳ	示強変数	名詞
ｼｷｮｸ	四極	連体詞
ｼｷｮｸﾃﾞﾝｼﾞｼｬｸ	四極電磁石	名詞
ｼｷｮｸﾍﾝｹｲ	四極変形	名詞
ｼｷｮｸﾎｳｼｬ	四極放射	名詞
ｼｷｮｸﾓｰﾒﾝﾄ	四極モーメント	名詞
ｼｷｮｸｼ	四極子	名詞
ｼｷｮｸｼｶﾞﾀ	四極子型	連体詞
ｼｷｮｸｼﾓｰﾒﾝﾄ	四極子モーメント	名詞
ｼｷｮｸｼﾝﾄﾞｳ	四極振動	名詞
ｼｷｮｸｼｿｳｺﾞｻﾖｳ	四極子相互作用	名詞
ｼｷｮｸｼﾂﾘｮｳﾌﾞﾝｾｷｹｲ	四極質量分析計
ｼﾏｼﾞｮｳｺｳｿﾞｳ	島状構造	名詞
ｼﾒﾝﾀｲｲﾁ	四面体位置	名詞
ｼﾒﾘﾄﾞ	湿り度	名詞
ｼﾒﾘﾎｳﾜｼﾞｮｳｷ	湿り飽和蒸気	名詞
ｼﾓﾝﾘｮｳｲｷ	指紋領域	名詞
ｼﾝｱﾜｾ	心合せ	名詞
ｼﾝﾃﾞﾝｶ	真電荷	名詞
ｼﾝﾄﾞｳﾊﾞﾝ	振動板	名詞
ｼﾝﾄﾞｳﾃﾞﾝﾘｭｳ	振動電流	名詞
ｼﾝﾄﾞｳﾃﾞﾝｼｿｳｺﾞｻﾖｳ	振動-電子相互作用	名詞
ｼﾝﾄﾞｳﾋﾈﾂ	振動比熱	名詞
ｼﾝﾄﾞｳﾎｳﾃｲｼｷ	振動方程式	名詞
ｼﾝﾄﾞｳｶｲﾃﾝｿｳｺﾞｻﾖｳ	振動-回転相互作用	名詞
ｼﾝﾄﾞｳｶﾝﾜ	振動緩和	名詞
ｼﾝﾄﾞｳｹｯｼｮｳﾎｳ	振動結晶法	名詞
ｼﾝﾄﾞｳｺｳ	振動項	名詞
ｼﾝﾄﾞｳｺｳｿﾞｳ	振動構造	名詞
ｼﾝﾄﾞｳﾒﾝ	振動面	名詞
ｼﾝﾄﾞｳﾒﾝﾌﾞﾝｶﾂ	振動面分割	名詞
ｼﾝﾄﾞｳﾓｰﾄﾞ	振動モード	名詞
ｼﾝﾄﾞｳﾉﾁｭｳｼﾝ	振動の中心	名詞
ｼﾝﾄﾞｳｵﾝﾄﾞ	振動温度	名詞
ｼﾝﾄﾞｳﾚｲｷ	振動励起	名詞
ｼﾝﾄﾞｳﾘｮｳｼｽｳ	振動量子数	名詞
ｼﾝﾄﾞｳｾﾝｲ	振動遷移	名詞
ｼﾝﾄﾞｳｾﾂﾄﾞｳ	振動摂動	名詞
ｼﾝﾄﾞｳｼ	振動子	名詞
ｼﾝﾄﾞｳｼｷｮｳﾄﾞ	振動子強度	名詞
ｼﾝﾄﾞｳｽﾍﾟｸﾄﾙ	振動スペクトル	名詞
ｼﾝﾄﾞｳｽｳｼﾞｮｳｹﾝ	振動数条件	名詞
ｼﾝﾄﾞｳﾃｲｽｳ	振動定数	名詞
ｼﾝﾄﾞｳﾖｳﾘｮｳﾃﾞﾝｲｹｲ	振動容量電位計	名詞
ｼﾝﾄﾞｳｼﾞｮｳﾀｲ	振動状態	名詞
ｼﾝﾄﾞｳｼﾞｭﾝｲ	振動準位	名詞
ｼﾝｺﾞｳｿｸﾄﾞ	信号速度	名詞
ｼﾝｸﾞｱﾗｳﾝﾄﾞﾎｳ	シングアラウンド法	名詞
ｼﾝﾋﾀﾞﾝｾｲｻﾝﾗﾝ	深非弾性散乱	名詞
ｼﾝｺｳﾊ	進行波	名詞
ｼﾝｺｳﾊｶﾝ	進行波管	名詞
ｼﾝｺﾃﾝｶｸｻﾝｹｲｽｳ	新古典拡散係数	名詞
ｼﾝｺﾃﾝﾕｿｳ	新古典輸送	名詞
ｼﾝｸｳｱｰｸ	真空アーク	名詞
ｼﾝｸｳﾍﾞﾝ	真空弁	名詞
ｼﾝｸｳﾌﾞﾝｺｳｷ	真空分光器	名詞
ｼﾝｸｳﾄﾞ	真空度	名詞
ｼﾝｸｳﾍｷｶｲ	真空へき開	名詞
ｼﾝｸｳﾍﾝｷｮｸ	真空偏極	名詞
ｼﾝｸｳﾎｳﾃﾞﾝ	真空放電	名詞
ｼﾝｸｳｶﾝﾃﾞﾝｱﾂｹｲ	真空管電圧計	名詞
ｼﾝｸｳｹｲ	真空計	名詞
ｼﾝｸｳｷﾀｲﾁ	真空期待値	名詞
ｼﾝｸｳｺﾝﾃﾞﾝｻｰ	真空コンデンサー	名詞
ｼﾝｸｳﾈﾂﾃﾞﾝﾂｲ	真空熱電対	名詞
ｼﾝｸｳﾎﾟﾝﾌﾟ	真空ポンプ	名詞
ｼﾝｸﾛｻｲｸﾛﾄﾛﾝ	シンクロサイクロトロン	名詞
ｼﾝｸﾛｽｺｰﾌﾟ	シンクロスコープ	名詞
ｼﾝｸﾛﾄﾛﾝ	シンクロトロン	名詞
ｼﾝｸﾛﾄﾛﾝﾎｳｼｬ	シンクロトロン放射	名詞
ｼﾝｸﾛﾄﾛﾝｶｿｸ	シンクロトロン加速	名詞
ｼﾝｸﾛﾄﾛﾝｼﾝﾄﾞｳ	シンクロトロン振動	名詞
ｼﾝｸｳｼｶﾞｲ	真空紫外	連体詞
ｼﾝｸｳｽｲｯﾁ	真空スイッチ	名詞
ｼﾝｸｳｼﾞｭﾝｲ	真空準位	名詞
ｼﾝｷｭｳﾄﾞ	真球度	名詞
ｼﾝﾆｭｳﾄﾞｼｹﾝ	針入度試験	名詞
ｼﾝﾆｭｳｶﾞﾀｺﾖｳﾀｲ	侵入型固溶体	名詞
ｼﾝﾆｭｳﾌｶｻ	侵入深さ	名詞
ｼﾝﾆｭｳｷｮﾘ	侵入距離	名詞
ｼﾝｵﾝ	震音	名詞
ｼﾝｵｳﾘｮｸ	真応力	名詞
ｼﾝﾌﾟｸﾌﾞﾝｶﾂ	振幅分割	名詞
ｼﾝﾌﾟｸﾊﾝｼｬﾘﾂ	振幅反射率	名詞
ｼﾝﾌﾟｸﾍﾝﾁｮｳ	振幅変調	名詞
ｼﾝﾌﾟｸﾎﾛｸﾞﾗﾑ	振幅ホログラム	名詞
ｼﾝﾌﾟｸｶｲｾｷ	振幅解析	名詞
ｼﾝﾌﾟｸｺｳｼ	振幅格子	名詞
ｼﾝﾌﾟｸﾓｰﾄﾞ	振幅モード	名詞
ｼﾝﾌﾟｸﾄｳｶﾘﾂ	振幅透過率	名詞
ｼﾝﾌﾟﾚｸﾃｨｯｸｸﾞﾝ	シンプレクティック群	名詞
ｼﾝﾌﾟｿﾝｿｸ	シンプソン則	名詞
ｼﾝﾗｲｸｶﾝ	信頼区間	名詞
ｼﾝﾗｲｽｲｼﾞｭﾝ	信頼水準	名詞
ｼﾝｾｲﾀﾞｲﾆｼｭ	真性第二種	連体詞
ｼﾝｾｲﾊﾝﾄﾞｳﾀｲ	真性半導体	名詞
ｼﾝｾｲﾘｮｳｲｷ	真性領域	名詞
ｼﾝｿｳｺﾝﾃﾞﾝｻｰ	進相コンデンサー	名詞
ｼﾝｽｲｺﾛｲﾄﾞ	親水コロイド	名詞
ｼﾝｼｮｸｺｳｶ	深色効果	名詞
ｼﾝｼｭｸｼﾝﾄﾞｳ	伸縮振動	名詞
ｼﾝﾀｲﾌｶﾘｮｳ	身体負荷量	名詞
ｼﾝﾁﾚｰｼｮﾝ	シンチレーション	名詞
ｼﾝﾁﾚｰｼｮﾝｹｲｽｳｶﾝ	シンチレーション計数管	名詞
ｼﾝﾁﾚｰﾀｰ	シンチレーター	名詞
ｼﾝﾁｽｷｬﾝﾆﾝｸﾞ	シンチスキャンニング	名詞
ｼﾝｻﾞｲﾑ	シンザイム	名詞
ｼﾝｼﾞｹｲ	心磁計	名詞
ｼﾝｼﾞｵﾀｸﾁｯｸｺｳﾌﾞﾝｼ	シンジオタクチック高分子	名詞
ｼﾝｼﾞｭｯｸﾋﾞｶｻﾞﾘﾓｹｲ	真珠首飾模型	名詞
ｼﾘｺﾝﾀﾞｲｵｰﾄﾞ	シリコンダイオード	名詞
ｼﾘｺﾝﾊﾝﾄﾞｳﾀｲ	シリコン半導体	名詞
ｼﾘｺﾝｺｳﾃﾞﾝﾁ	シリコン光電池	名詞
ｼﾘｮｳﾍﾝｽｳ	示量変数	名詞
ｼｻﾎﾞｳﾁｮｳｹｲ	示差膨張計	名詞
ｼｻﾈﾂﾌﾞﾝｾｷ	示差熱分析	名詞
ｼｻｿｳｻﾈﾂﾘｮｳｹｲ	示差走査熱量計	名詞
ｼｼｶﾊﾞﾌﾞｺｳｿﾞｳ	シシカバブ構造	名詞
ｼｽｳﾌﾞﾝﾌﾟ	指数分布	名詞
ｼｽｶﾞﾀ	シス形	名詞
ｼｽｲ	死水	名詞
ｼｽｳｶﾝｽｳｼﾞｯｹﾝ	指数関数実験	名詞
ｼﾁｼﾞｭｳｺｳ	七重項	名詞
ｼﾁｼﾞｭｳｾﾝ	七重線	名詞
ｼｯﾃﾝ	質点	名詞
ｼｯﾃﾝｹｲ	質点系	名詞
ｼｯﾃﾝﾘｷｶﾞｸ	質点力学	名詞
ｼｯﾄｳ	失透	名詞
ｼﾂﾘｮｳﾌﾞﾝｾｷﾎｳ	質量分析法	名詞
ｼﾂﾘｮｳﾌﾞﾝｾｷ	質量分析	名詞
ｼﾂﾘｮｳﾌﾞﾝｾｷｷ	質量分析器	名詞
ｼﾂﾘｮｳﾎｳﾌﾞﾂｾﾝ	質量放物線	名詞
ｼﾂﾘｮｳﾎｿﾞﾝｿｸ	質量保存則	名詞
ｼﾂﾘｮｳﾎｿﾞﾝﾉﾎｳｿｸ	質量保存の法則	名詞
ｼﾂﾘｮｳｹｯｿﾝ	質量欠損	名詞
ｼﾂﾘｮｳｺｳﾄﾞｶﾝｹｲ	質量光度関係	名詞
ｼﾂﾘｮｳｺｳｼｷ	質量公式	名詞
ｼﾂﾘｮｳｷｭｳｼｭｳｹｲｽｳ	質量吸収係数	名詞
ｼﾂﾘｮｳﾉｶﾀﾖﾘﾆﾖﾙﾎｾｲ	質量のかたよりによる補正	名詞
ｼﾂﾘｮｳﾉｸﾘｺﾐ	質量のくりこみ	名詞
ｼﾂﾘｮｳﾁｭｳｼﾝ	質量中心	名詞
ｼﾂﾘｮｳﾉﾁｭｳｼﾝ	質量の中心	名詞
ｼﾂﾘｮｳﾘｭｳﾘｮｳｹｲ	質量流量計	名詞
ｼﾂﾘｮｳｻﾖｳﾉﾎｳｿｸ	質量作用の法則	名詞
ｼﾂﾘｮｳｿｸ	質量則	名詞
ｼﾂﾘｮｳｽｳ	質量数	名詞
ｼﾂﾘｮｳｽﾍﾟｸﾄﾙ	質量スペクトル	名詞
ｼﾂﾘｮｳﾀﾝｲ	質量単位	名詞
ｼﾂﾘｮｳﾁｭｳｼﾝｹｲ	質量中心系	名詞
ｼﾂﾃｲｽｳ	室定数	名詞
ｼﾂｼﾞｭﾝﾀﾞﾝﾈﾂｹﾞﾝﾘﾂ	湿潤断熱減率	名詞
ｼﾂｼﾞｭﾝｾｲ	湿潤性	名詞
ｼﾂｼﾞｭﾝﾁｮｳﾘｮｸ	湿潤張力	名詞
ｼﾔﾚﾝｽﾞ	視野レンズ	名詞
ｼﾔﾘﾝｸﾞｶﾝｼｮｳｹｲ	シヤリング干渉計	名詞
ｼｾﾞﾝﾊﾊﾞ	自然幅	名詞
ｼｾﾞﾝﾋｽﾞﾐ	自然ひずみ	名詞
ｼｾﾞﾝﾎｳｼｬﾉｳ	自然放射能	名詞
ｼｾﾞﾝﾎｳｼｬｾｲｶｸｼｭ	自然放射性核種	名詞
ｼｾﾞﾝﾎｳｼｬｿﾞｳﾌｸｺｳ	自然放射増幅光	名詞
ｼｾﾞﾝﾎｳｼｭﾂ	自然放出	名詞
ｼｾﾞﾝｶｶﾞｸ	自然科学	名詞
ｼｾﾞﾝｷﾄﾞｳ	自然軌道	名詞
ｼｾﾞﾝｷﾄﾞｳｶﾝｽｳ	自然軌道関数	名詞
ｼｾﾞﾝｾﾝｺｳｾｲ	自然旋光性	名詞
ｼｾﾞﾝﾀｲﾘｭｳ	自然対流	名詞
ｼｾﾞﾝﾀﾝｲ	自然単位	名詞
ｼｾﾞﾝﾁｮｳｵﾝｶｲ	自然長音階	名詞
ｼｼﾞｭｳｺｳ	四重項	名詞
ｼｼﾞｭｳｺｳｼﾞｮｳﾀｲ	四重項状態	名詞
ｼｼﾞｭｳｾﾝ	四重線	名詞
ｿｳｱﾝﾃｲ	双安定	連体詞
ｿｳｱﾂ	総圧	名詞
ｿｳﾌﾞﾝﾘ	相分離	名詞
ｿｰﾀﾞｰ	ソーダー	名詞
ｿﾃﾞﾝｶ	素電荷	名詞
ｿｳﾃﾞﾝｾﾝﾛ	送電線路	名詞
ｿｹﾞﾝﾊ	素元波	名詞
ｿｳｺﾞｲﾝﾀﾞｸﾀﾝｽ	相互インダクタンス	名詞
ｿｳｺﾞｶｸｻﾝ	相互拡散	名詞
ｿｳｺﾞｺﾋｰﾚﾝｽ	相互コヒーレンス	名詞
ｿｳｺﾞｺﾝﾀﾞｸﾀﾝｽ	相互コンダクタンス	名詞
ｿｳｺﾞｺｳｾｲ	相互校正	名詞
ｿｳｺﾞｻﾖｳ	相互作用	名詞
ｿｳｺﾞｻﾖｳﾋｮｳｼﾞ	相互作用表示	名詞
ｿｳｺﾞｼﾝﾆｭｳｱﾐﾒ	相互侵入網目	名詞
ｿｳｺﾞﾁｭｳｾｲｶ	相互中性化	名詞
ｿｳｺﾞﾕｳﾄﾞｳ	相互誘導	名詞
ｿｳﾊﾝｶｲﾛ	相反回路	名詞
ｿﾊﾝﾉｳ	素反応	名詞
ｿｳﾊﾝｾｲ	相反性	名詞
ｿｳﾊﾝｿｸ	相反則	名詞
ｿｳﾊﾝｿｸﾌｷ	相反則不軌	名詞
ｿｳﾊﾝﾃｲﾘ	相反定理	名詞
ｿｳﾍｲｺｳ	相平衡	名詞
ｿｳﾍﾝｶ	相変化	名詞
ｿｳﾍﾝﾀｲ	相変態	名詞
ｿｳﾎｶｲﾛ	相補回路	名詞
ｿｳﾎｾｲ	相補性	名詞
ｿﾌﾄｱﾊﾟｰﾁｬｰ	ソフトアパーチャー	名詞
ｿﾌﾄﾓｰﾄﾞ	ソフトモード	名詞
ｿﾌﾄﾊﾟｲｷｮｸｹﾞﾝ	ソフトパイ極限	名詞
ｿｳｶﾍｲｷﾝ	相加平均	名詞
ｿｳｶﾝﾌﾞﾝｾｷ	相関分析	名詞
ｿｳｶﾝｴﾈﾙｷﾞｰ	相関エネルギー	名詞
ｿｳｶﾝﾌﾄｳｼｷ	相関不等式	名詞
ｿｳｶﾝｶﾝｽｳ	相関関数	名詞
ｿｳｶﾝｶﾝｼｮｳｷｮﾘ	相関干渉距離	名詞
ｿｳｶﾝｹｲｽｳ	相関係数	名詞
ｿｳｶﾝｷｮﾘ	相関距離	名詞
ｿｳｶﾝｽｲ	層間水	名詞
ｿｳｶﾝﾄｳｼｷ	相関等式	名詞
ｿｳｶﾝﾁｮｳ	相関長	名詞
ｿｳｶﾝｼﾞｶﾝ	相関時間	名詞
ｿｳｶﾝｽﾞ	相関図	名詞
ｿｶﾃｲ	素過程	名詞
ｿｳｷﾄﾞｳ	相軌道	名詞
ｿｯｺｳｷ	測光器	名詞
ｿｳｺｳｼﾞｶﾝ	走行時間	名詞
ｿｳｸﾊﾞｸﾃﾞﾝｼ	束縛電子	名詞
ｿｸﾊﾞｸｶｲﾃﾝ	束縛回転	名詞
ｿｸﾊﾞｸｶｲﾃﾝｻ	束縛回転鎖	名詞
ｿｸﾊﾞｸﾚｲｷｼ	束縛励起子	名詞
ｿｸﾊﾞｸﾘｮｸ	束縛力	名詞
ｿｸﾊﾞｸｿｸﾊﾞｸｾﾝｲ	束縛-束縛遷移	名詞
ｿｸﾊﾞｸｳﾝﾄﾞｳ	束縛運動	名詞
ｿｸﾊﾞｸｳｽﾞ	束縛渦	名詞
ｿｸﾊﾞｸｼﾞﾕｳｾﾝｲ	束縛-自由遷移	名詞
ｿｸﾊﾞｸｼﾞｮｳﾀｲ	束縛状態	名詞
ｿｸﾋﾞｹﾝﾋﾞｷｮｳ	測微顕微鏡	名詞
ｿｸﾄﾞ	測度	名詞
ｿｸﾄﾞﾌﾞﾝﾌﾟｶﾝｽｳ	速度分布関数	名詞
ｿｸﾄﾞﾍﾝﾁｮｳｶﾝ	速度変調管	名詞
ｿｸﾄﾞｲｿﾞﾝﾎﾟﾃﾝｼｬﾙ	速度依存ポテンシャル	名詞
ｿｸﾄﾞｶﾃｲ	速度過程	名詞
ｿｸﾄﾞｸｳｶﾝﾌｱﾝﾃｲｾｲ	速度空間不安定性	名詞
ｿｸﾄﾞﾎﾟﾃﾝｼｬﾙ	速度ポテンシャル	名詞
ｿｸﾄﾞｾﾝﾍﾞﾂｷ	速度選別器	名詞
ｿｸﾊﾀｲ	側波帯	名詞
ｿｸﾊﾂｶﾞﾝﾏｾﾝ	即発γ線	名詞
ｿｸﾊﾂｾｲｺｳｶ	即発性効果	名詞
ｿｸﾊﾂﾁｭｳｾｲｼ	即発中性子	名詞
ｿｸﾒﾝｼｮｳﾄﾂ	側面衝突	名詞
ｿｸｼｮｸ	測色	名詞
ｿｸﾃｲｶﾞｸ	測定学	名詞
ｿｸﾁｾﾝ	測地線	名詞
ｿｸﾁｾﾝﾍﾝｻﾉﾎｳﾃｲｼｷ	測地線偏差の方程式	名詞
ｿｸﾁｾﾝｻｲｻ	測地線歳差	名詞
ｿｸﾁｾﾝｻﾞﾋｮｳｹｲ	測地線座標系	名詞
ｿｸﾁｻﾞﾋｮｳ	測地座標	名詞
ｿｸﾁｭｳｾｲｼ	速中性子	名詞
ｿｳｷｮｳｶｲ	相境界	名詞
ｿｳｷｮｸﾃﾞﾝﾊﾞ	双極電場	名詞
ｿｳｷｮｸﾎｳｼｬ	双極放射	名詞
ｿｳｷｮｸﾓｰﾒﾝﾄ	双極モーメント	名詞
ｿｳｷｮｸｾﾝｲ	双極遷移	名詞
ｿｳｷｮｸｼ	双極子	名詞
ｿｳｷｮｸｼｷﾀｲ	双極子気体	名詞
ｿｳｷｮｸｼﾓｰﾒﾝﾄ	双極子モーメント	名詞
ｿｳｷｮｸｼﾝﾄﾞｳ	双極振動	名詞
ｿｳｷｮｸｼｵﾝｹﾞﾝ	双極子音源	名詞
ｿｳｷｮｸｼｿｳｼｮｸｼ	双極子-双極子	連体詞
ｿｳｷｮｸｼﾞﾊﾞ	双極磁場	名詞
ｿﾅｰ	ソナー	名詞
ｿﾅｸﾞﾗﾌ	ソナグラフ	名詞
ｿｳﾆｼﾞｺｳｶﾝｿｳｺﾞｻﾖｳ	双二次交換相互作用	名詞
ｿﾉﾊﾞｶﾝｻﾂ	その場観察	名詞
ｿﾝｼﾂﾀﾞﾝｾｲﾘﾂ	損失弾性率	名詞
ｿﾝｼﾂｶｸ	損失角	名詞
ｿﾝｼﾂｺｰﾝ	損失コーン	名詞
ｿｳﾆｭｳｹﾞﾝｼ	挿入原子	名詞
ｿﾝｻﾞｲﾄﾞ	存在度	名詞
ｿｳｵﾝﾋｮｳｶ	騒音評価	名詞
ｿｳｵﾝｹｲ	騒音計	名詞
ｿｳｵﾝﾚﾍﾞﾙ	騒音レベル	名詞
ｿｰﾌﾟｼｮﾝﾎﾟﾝﾌﾟ	ソープションポンプ	名詞
ｿﾗﾘｾﾞｰｼｮﾝ	ソラリゼーション	名詞
ｿﾚｲｷ	素励起	名詞
ｿﾚｲﾕﾉﾎｼｮｳﾊﾞﾝ	ソレイユの補償板	名詞
ｿｰﾚｺｳｶ	ソーレ効果	名詞
ｿﾚﾉｲﾄﾞ	ソレノイド	名詞
ｿﾚﾉｲﾄﾞﾊﾞ	ソレノイド場	名詞
ｿﾘｯﾄﾞﾃｲｺｳｷ	ソリッド抵抗器	名詞
ｿﾘﾄﾝ	ソリトン	名詞
ｿｳﾘﾂ	相律	名詞
ｿﾘｮｳ	素量	名詞
ｿｳﾘｭｳ	層流	名詞
ｿﾘｭｳｼﾌﾞﾂﾘｶﾞｸ	素粒子物理学	名詞
ｿﾘｭｳｼﾛﾝ	素粒子論	名詞
ｿｳﾘｭｳﾃｲｿｳ	層流底層	名詞
ｿｳｻﾃﾞﾝｼｹﾝﾋﾞｷｮｳ	走査電子顕微鏡	名詞
ｿｳｻｶﾞﾀ	走査型	連体詞
ｿｳｻﾄﾝﾈﾙｹﾝﾋﾞｷｮｳ	走査トンネル顕微鏡	名詞
ﾄﾝﾈﾙｹﾝﾋﾞｷｮｳ	トンネル顕微鏡	名詞
ｿｳｻﾂｺｳ	相殺項	名詞
ｿｾｲﾊ	塑性波	名詞
ｿｾｲﾍﾝｹｲ	塑性変形	名詞
ｿｾｲｶｲｾｷ	塑性解析	名詞
ｿｾｲｺｳｿｸｹｲｽｳ	塑性拘束係数	名詞
ｿｾｲﾘｭｳﾄﾞｳ	塑性流動	名詞
ｿｾｲｾｯｹｲ	塑性設計	名詞
ｿｰｾｰｼﾞﾌｱﾝﾃｲｾｲ	ソーセージ不安定性	名詞
ｿｰｾｰｼﾞｶﾞﾀﾌｱﾝﾃｲｾｲ	ソーセージ型不安定性	名詞
ｿｼﾀﾞﾝﾒﾝｾｷ	阻止断面積	名詞
ｿｼｶ	粗視化	名詞
ｿｼｷﾄｳｶﾌﾞｯｼﾂ	組織等価物質	名詞
ｿｼｷﾄｳｶｹﾝｼｭﾂｷ	組織等価検出器	名詞
ｿｳｼﾝｶﾝ	送信管	名詞
ｿｳｼﾝｷ	送信器	名詞
ｿｼﾉｳ	阻止能	名詞
ｿｽｲｹﾂｺﾞｳ	疎水結合	名詞
ｿｽｲｺﾛｲﾄﾞ	疎水コロイド	名詞
ｿｽｲｾｲ	疎水性	名詞
ｿｳｼｮｳ	双晶	名詞
ｿｳｼｮｳﾍﾝｹｲ	双晶変形	名詞
ｿｳｼｮｳｺｳｿﾞｳ	双晶構造	名詞
ｿｳｼｮｳｷｮｳｶｲ	双晶境界	名詞
ｼｮｳｼｮｳﾒﾝ	双晶面	名詞
ｿｳﾀｲｱﾂ	相対圧	名詞
ｿｳﾀｲｱﾂﾘｮｸ	相対圧力	名詞
ｿｳﾀｲｶﾝﾄﾞ	相対感度	名詞
ｿｳﾀｲｶｿｸﾄﾞ	相対加速度	名詞
ｿｳﾀｲﾈﾝﾄﾞ	相対粘度	名詞
ｿｳﾀｲﾛﾝ	相対論	名詞
ｿｳﾀｲﾛﾝﾃｷ	相対論的	連体詞
ｿｳﾀｲﾛﾝﾃｷﾌﾍﾝﾘｮｳ	相対論的不変量	名詞
ｿｳﾀｲﾛﾝﾃｷﾘｷｶﾞｸ	相対論的力学	名詞
ｿｳﾀｲｾｲ	相対性	名詞
ｿｳﾀｲｾｲｹﾞﾝﾘ	相対性原理	名詞
ｿｳﾀｲｾｲﾘﾛﾝ	相対性理論	名詞
ｿｳﾀｲｼﾂﾄﾞ	相対湿度	名詞
ｿｳﾀｲｿｸﾄﾞ	相対速度	名詞
ｿｳﾀｲｳﾝﾄﾞｳ	相対運動	名詞
ｿｳﾀｲｻﾞﾋｮｳ	相対座標	名詞
ｿｳﾃﾝｲ	相転移	名詞
ｿｳﾁｶﾝｽｳ	装置関数	名詞
ｿｳﾄｳｵｳﾘｮｸ	相当応力	名詞
ｿｳﾄｳﾀﾝﾌﾘｺ	相当単振り子	名詞
ｿｳﾂｲﾍﾝｶﾝ	相対変換	名詞
ｿｳﾂｲﾓｹｲ	相対模型	名詞
ｿｳﾂｲｾｲ	相対性	名詞
ｿｳﾜｿｸ	総和則	名詞
ｿｳﾖｳｾｲ	相溶性	名詞
ｿｼﾞｺﾝ	ソジコン	名詞
ｿｳｼﾞｷｮｸｾﾝ	走時曲線	名詞
ｿｳｼﾞｮｳﾌﾞｯｼﾂ	層状物質	名詞
ｿｳｼﾞｮｳﾍｲｷﾝ	相乗平均	名詞
ｿｳｼﾞｮｳｹｯｼｮｳ	層状結晶	名詞
ｿｳｼﾞｮｳｺｳｿﾞｳ	層状構造	名詞
ｿｳｼﾞｮｳｾｲﾁｮｳ	層状成長	名詞
ｽﾍﾞﾘｹｲ	すべり系	名詞
ｽﾍﾞﾘﾏｻﾂ	滑り摩擦	名詞
ｽﾍﾞﾘﾒﾝ	すべり面	名詞
ｽﾍﾞﾘﾉｹｲｽｳ	滑りの係数	名詞
ｽﾍﾞﾘｾﾝ	すべり線	名詞
ｽﾍﾞﾘﾃｲｺｳｷ	滑り抵抗器	名詞
ｽﾍﾞﾘｳﾝﾄﾞｳ	すべり運動	名詞
ｽｴﾘﾝｸﾞ	スエリング	名詞
ｽﾌｪﾘｼﾃｨ	スフェリシティ	名詞
ｽｲｱﾂﾌﾟﾚｽ	水圧プレス	名詞
ｽｲｷﾞﾝｱﾂﾘｮｸｹｲ	水銀圧力計	名詞
ｽｲｷﾞﾝｶｸｻﾝﾎﾟﾝﾌﾟ	水銀拡散ポンプ	名詞
ｽｲｷﾞﾝｷｱﾂｹｲ	水銀気圧計	名詞
ｽｲｷﾞﾝｵﾝﾄﾞｹｲ	水銀温度計	名詞
ｽｲｷﾞﾝｾｲﾘｭｳｷ	水銀整流器	名詞
ｽｲｷﾞﾝﾁｭｳｾﾝﾁﾒｰﾄﾙ	水銀柱センチメートル	名詞
ｽｲﾍｲﾌﾞﾝﾘｮｸ	水平分力	名詞
ｽｲﾍｲﾌﾘｺ	水平振り子	名詞
ｽｲﾍｲﾒﾝ	水平面	名詞
ｽｲﾍｲｾｲﾌﾞﾝ	水平成分	名詞
ｽｲﾎ	酔歩	名詞
ｽｲﾌｳﾎﾟﾝﾌﾟ	水封ポンプ	名詞
ｽｲｲｹｲ	水位計	名詞
ｽｲｺﾐ	吸込み	名詞
ｽｲﾒﾝ	錐面	名詞
ｽｲﾒﾝﾊ	水面波	名詞
ｽｲﾈﾂｺﾞｳｾｲﾎｳ	水熱合成法	名詞
ｽｲﾘｷｶﾞｸ	水力学	名詞
ｽｲﾘｷﾁｮｯｹｲ	水力直径	名詞
ｽｲﾘｭｳｵﾝﾌﾟ	水流ポンプ	名詞
ｽｲｿｱﾜﾊﾞｺ	水素泡箱	名詞
ｽｲｿﾃﾞﾝﾁ	水素電池	名詞
ｽｲｿｹﾞﾝｼ	水素原子	名詞
ｽｲｿｲﾄﾞｳｼﾞｭｳｺﾞｳ	水素移動重合	名詞
ｽｲｿｲｵﾝﾉｳﾄﾞ	水素イオン濃度	名詞
ｽｲｿｶ	水素化	名詞
ｽｲｿｹﾂｺﾞｳ	水素結合	名詞
ｽｲｿﾒｰｻﾞｰ	水素メーザー	名詞
ｽｲｿﾚｰｻﾞｰ	水素レーザー	名詞
ｽｲｿﾖｳｹﾞﾝｼ	水素様原子	名詞
ｽｲｿﾖｳｲｵﾝ	水素様イオン	名詞
ｽｲｿｾﾞｲｶ	水素脆化	名詞
ｽｲｼｮｳﾄﾞｹｲ	水晶時計	名詞
ｽｲｼｮｳﾌｨﾙﾀｰ	水晶フィルター	名詞
ｽｲｼｮｳﾊｯｼﾝｷ	水晶発振器	名詞
ｽｲｼｮｳｼﾝﾄﾞｳｼ	水晶振動子	名詞
ｽｲｯﾁﾝｸﾞｶｲﾛ	スイッチング回路	名詞
ｽｲｯﾁﾝｸﾞｼﾞｶﾝ	スイッチング時間	名詞
ｽｲﾁｮｸﾊﾞﾝﾄﾞ	垂直バンド	名詞
ｽｲﾁｮｸｺｳﾘｮｸ	垂直抗力	名詞
ｽｲﾁｮｸｵｳﾘｮｸ	垂直応力	名詞
ｽｲﾁｮｸﾘｮｸ	垂直力	名詞
ｽｲﾁｮｸｼｮｳｹﾞｷﾊ	垂直衝撃波	名詞
ｽｲﾁｮｸｼﾞｶﾘﾂ	垂直磁化率	名詞
ｽｲﾁｭｳｵﾝｷｮｳ	水中音響	名詞
ｽｲﾁｭｳｵﾝｷｮｳｶﾞｸ	水中音響学	名詞
ｽｲﾁｭｳｾﾝﾁﾒｰﾄﾙ	水柱センチメートル	名詞
ｽｲﾁｭｳﾁｮｳｵﾝｷ	水中聴音器	名詞
ｽｲﾜ	水和	名詞
ｽｲﾜﾃﾞﾝｼ	水和電子	名詞
ｽｲﾜﾈﾂ	水和熱	名詞
ｽｲﾖｳｴｷﾎｳ	水溶液法	名詞
ｽｲｼﾞｭﾝﾒﾝ	水準面	名詞
ｽｳｶｲｻﾝﾗﾝ	数回散乱	名詞
ｽｶｲｼｬｲﾝ	スカイシャイン	名詞
ｽｶﾗｰ	スカラー	名詞
ｽｶﾗｰﾊﾞ	スカラー場	名詞
ｽｶﾗｰｷｮｸﾘﾂ	スカラー曲率	名詞
ｽｶﾗｰﾎﾟﾃﾝｼｬﾙ	スカラーポテンシャル	名詞
ｽｶﾗｰﾘｭｳｼ	スカラー粒子	名詞
ｽｶﾗｰｾｷ	スカラー積	名詞
ｽｶﾗｰﾁｭｳｶﾝｼ	スカラー中間子	名詞
ｽｹｰﾗｰ	スケーラー	名詞
ｽｹｰﾘﾝｸﾞｿｸ	スケーリング則	名詞
ｽｹｰﾙﾊｲﾄ	スケールハイト	名詞
ｽｹｰﾙﾌﾍﾝｾｲ	スケール不変性	名詞
ｽｷﾏｰ	スキマー	名詞
ｽｷﾙﾐｵﾝ	スキルミオン	名詞
ｽｷﾙﾑﾘｮｸ	スキルム力	名詞
ｽｸﾘｭｰﾋﾟﾝﾁ	スクリューピンチ	名詞
ｽｸﾘｭｰｼﾞｷｺｳｿﾞｳ	スクリュー磁気構造	名詞
ｽｷｬﾆﾝｸﾞﾄｳｴｲｷ	スキャニング投影器	名詞
ｽｷｭｰｺｳｾﾝ	スキュー光線	名詞
ｽﾒｸﾁｯｸｿｳ	スメクチック相	名詞
ｽﾐｽｶﾝｼｮｳｹｲ	スミス干渉計	名詞
ｽﾐｽｻﾞﾋｮｳ	スミス座標	名詞
ｽｳﾐﾂﾄﾞ	数密度	名詞
ｽﾅｯﾌﾟｵﾌﾀﾞｲｵｰﾄﾞ	スナップオフダイオード	名詞
ｽﾈｰｸﾋﾟｰｸ	スネークピーク	名詞
ｽﾈﾙﾉﾎｳｿｸ	スネルの法則	名詞
ｽﾝﾎﾟｳｺｳｶ	寸法効果	名詞
ｽﾇｹｺｳｶ	すぬけ効果	名詞
ｽｵｰﾑｼﾞｯｹﾝ	スオーム実験	名詞
ｽｰﾊﾟｰﾍﾃﾛﾀﾞｲﾝ	スーパーヘテロダイン	名詞
ｽﾊﾟｲｸﾊｯｼﾝ	スパイク発振	名詞
ｽﾊﾟｲｷｭｰﾙ	スパイキュール	名詞
ｽﾊﾟｰｸｷﾞｬｯﾌﾟ	スパークギャップ	名詞
ｽﾊﾟｰｸｺｳｹﾞﾝ	スパーク光源	名詞
ｽﾊﾟｰｸｾﾝ	スパーク線	名詞
ｽﾊﾟｰｸﾁｪﾝﾊﾞｰ	スパークチェンバー	名詞
ｽｰﾊﾟｰﾘｰｸ	スーパーリーク	名詞
ｽﾊﾟｯﾀ	スパッタ	名詞
ｽﾊﾟｯﾀｲｵﾝﾎﾟﾝﾌﾟ	スパッタイオンポンプ	名詞
ｽﾊﾟﾀﾘﾝｸﾞ	スパッタリング	名詞
ｽｰﾊﾟｰｳｨｰｸﾘﾛﾝ	スーパーウィーク理論	名詞
ｽﾍﾟｯｸﾙﾊﾟﾀｰﾝ	スペックルパターン	名詞
ｽﾍﾟｸﾄﾛﾒｰﾀｰ	スペクトロメーター	名詞
ｽﾍﾟｸﾄﾛｽｺﾋﾟｰ	スペクトロスコピー	名詞
ｽﾍﾟｸﾄﾙﾌﾞﾝｶｲ	スペクトル分解	名詞
ｽﾍﾟｸﾄﾙﾌﾞﾝｶｲﾉｳ	スペクトル分解能	名詞
ｽﾍﾟｸﾄﾙﾌﾞﾝﾘｲﾝｼ	スペクトル分離因子	名詞
ｽﾍﾟｸﾄﾙﾌﾞﾝｾｷｷ	スペクトル分析器	名詞
ｽﾍﾟｸﾄﾙｶﾞﾀ	スペクトル型	名詞
ｽﾍﾟｸﾄﾙﾋｮｳｼﾞ	スペクトル表示	名詞
ｽﾍﾟｸﾄﾙｶｸｻﾝ	スペクトル拡散	名詞
ｽﾍﾟｸﾄﾙｶﾝｽｳ	スペクトル関数	名詞
ｽﾍﾟｸﾄﾙｹｲﾚﾂ	スペクトル系列	名詞
ｽﾍﾟｸﾄﾙｺｳ	スペクトル項	名詞
ﾉｳﾄﾞﾉｼｭｳﾁｭｳ	濃度の集中	名詞
ｽﾍﾟｸﾄﾙｾﾝ	スペクトル線	名詞
ｽﾍﾟｸﾄﾙｾﾝﾊﾊﾞ	スペクトル線幅	名詞
ｽﾍﾟｸﾄﾙｾﾝﾉﾊﾊﾞ	スペクトル線の幅	名詞
ｽﾍﾟｸﾄﾙｾﾝﾉﾋﾛｶﾞﾘ	スペクトル線の広がり	名詞
ｽﾍﾟｸﾄﾙｾﾝﾉｶﾀﾁ	スペクトル線の形	名詞
ｽﾍﾟｸﾄﾙｼﾞｽｳ	スペクトル次数	名詞
ｽﾍﾟｯﾀﾘﾝｸﾞ	スペッタリング	名詞
ｽﾋﾟﾝ	スピン	名詞
ｽﾋﾟﾝｴｺｰ	スピンエコー	名詞
ｽﾋﾟﾈﾙ	スピネル	名詞
ｽﾋﾟﾝﾌｫﾉﾝｿｳｺﾞｻﾖｳ	スピン-フォノン相互作用	名詞
ｽﾋﾟﾝｸﾞﾗｽ	スピングラス	名詞
ｽﾋﾟﾝﾊ	スピン波	名詞
ｽﾋﾟﾝﾊｲﾚﾂ	スピン配列	名詞
ｽﾋﾟﾝﾊﾐﾙﾄﾆｱﾝ	スピンハミルトニアン	名詞
ｽﾋﾟﾝﾍﾝｷｮｸ	スピン偏極	名詞
ｽﾋﾟﾝﾋｶﾝｼｮｳｾｲ	スピン非干渉性	名詞
ｽﾋﾟﾝﾌｸｼﾞｭﾝｲ	スピン副準位	名詞
ｽﾋﾟﾝﾌﾘｯﾌﾟ	スピンフリップ	名詞
ｽﾋﾟﾝﾌﾘｯﾌﾟｶﾃｲ	スピンフリップ過程	名詞
ｽﾋﾟﾝﾌﾛｯﾌﾟ	スピンフロップ	名詞
ｽﾋﾟﾝｲｿﾞﾝﾘｮｸ	スピン依存力	名詞
ｽﾋﾟﾝｶｲﾃﾝﾎｳ	スピン回転法	名詞
ｽﾋﾟﾝｷﾄﾞｳ	スピン軌道	名詞
ｽﾋﾟﾝｷﾄﾞｳﾌﾞﾝﾘ	スピン-軌道分離	名詞
ｽﾋﾟﾝｷﾄﾞｳｶﾝｽｳ	スピン軌道関数	名詞
ｽﾋﾟﾝｷﾄﾞｳｹﾂｺﾞｳ	スピン-軌道結合	名詞
ｽﾋﾟﾝｷﾄﾞｳﾘｮｸ	スピン-軌道力	名詞
ｽﾋﾟﾝｷﾄﾞｳｿｳｺﾞｻﾖｳ	スピン-軌道相互作用	名詞
ｽﾋﾟﾝｺｳｼｶﾝﾜ	スピン-格子緩和	名詞
ｽﾋﾟﾝｷｮｳﾒｲ	スピン共鳴	名詞
ｽﾋﾟﾝﾐﾂﾄﾞｷﾞｮｳﾚﾂ	スピン密度行列	名詞
ｽﾋﾟﾝﾐﾂﾄﾞﾊ	スピン密度波	名詞
ｽﾋﾟﾝﾆｼﾞｭｳﾌﾞﾝﾘ	スピン二重分離	名詞
ｽﾋﾟﾝﾆｼﾞｭｳｺｳ	スピン二重項	名詞
ｽﾋﾟﾝﾆｼﾞｭｳｾﾝ	スピン二重線	名詞
ｽﾋﾟﾝﾉﾕﾗｷﾞ	スピンのゆらぎ	名詞
ｽﾋﾟﾉｰﾀﾞﾙﾌﾞﾝｶｲ	スピノーダル分解	名詞
ｽﾋﾟﾉﾙ	スピノル	名詞
ｽﾋﾟﾉﾙﾊﾞ	スピノル場	名詞
ｽﾋﾟﾝﾊﾟｲｴﾙｽﾃﾝｲ	スピンパイエルス転移	名詞
ｽﾋﾟﾝﾘｮｳｼｽｳ	スピン量子数	名詞
ｽﾋﾟﾝｿｳｶﾝ	スピン相関	名詞
ｽﾋﾟﾝｽﾋﾟﾝｶﾝﾜ	スピン-スピン緩和	名詞
ｽﾋﾟﾝｽﾋﾟﾝｿｳｺﾞｻﾖｳ	スピン-スピン相互作用	名詞
ｽﾋﾟﾝﾂｲｿｳｶﾝｶﾝｽｳ	スピン対相関関数	名詞
ｽﾎﾟｯﾄｻｲｽﾞ	スポットサイズ	名詞
ｽﾌﾟﾗｲﾝ	スプライン	名詞
ｽﾌﾟﾚｯﾄﾞﾌｧﾝｸｼｮﾝ	スプレッドファンクション	名詞
ｽﾌﾟﾚｰﾎｳﾃﾞﾝ	スプレー放電	名詞
ｽﾌﾟﾚﾝｹﾞﾙﾎﾟﾝﾌﾟ	スプレンゲルポンプ	名詞
ｽﾌﾟｰﾘｱｽｼﾞｮｳﾀｲ	スプーリアス状態	名詞
ｽﾌﾟｰﾘｵﾝ	スプーリオン	名詞
ｽﾗｽﾄ	スラスト	名詞
ｽﾚｽﾚﾆｭｳｼｬ	すれすれ入射	名詞
ｽﾚｰﾀｰ	スレーター	人名
ｽﾚｰﾀｰ	Slater	人名
ｽﾚｰﾀｰｶﾞﾀｷﾄﾞｳ	スレーター型軌道	名詞
ｽﾚｰﾀｰｶﾞﾀｷﾄﾞｳｶﾝｽｳ	スレーター型軌道関数	名詞
ｽﾚｰﾀｰｷﾞｮｳﾚﾂｼｷ	スレーター行列式	名詞
ｽﾚｰﾀｰﾎﾟｰﾘﾝｸﾞﾎｳ	スレーター・ポーリング法	名詞
ｽﾚｰﾀｰｿｸ	スレーター則	名詞
ｽｳﾘﾌﾞﾂﾘｶﾞｸ	数理物理学	名詞
ｽｳﾘｹｯｼｮｳｶﾞｸ	数理結晶学	名詞
ｽｰﾙｺｳｶ	スール効果	名詞
ｽﾙｰﾌﾟｯﾄ	スループット	名詞
ｽﾙｰﾌﾟｯﾄﾉﾘﾄｸ	スループットの利得	名詞
ｽﾀｶﾞｰﾄﾞｿｳﾃﾝｲ	スタガード相転移	名詞
ｽﾀｶﾞｰｿﾞｳﾌｸｷ	スタガー増幅器	名詞
ｽﾀﾝﾄﾝｽｳ	スタントン数	名詞
ｽﾀｰﾊﾟﾀｰﾝ	スターパターン	名詞
ｽﾀｰﾘﾝｸﾞﾉｺｳｼｷ	スターリングの公式	名詞
ｽﾃｰﾌﾞﾗｰﾛﾝｽｷｰｺｳｶ	ステーブラー・ロンスキー効果	名詞
ｽﾃｯﾌﾟｵｳﾄｳ	ステップ応答	名詞
ｽﾃｯﾌﾟﾘｶﾊﾞﾘｰ	ステップリカバリー	連体詞
ｽﾃﾗﾚｰﾀｰ	ステラレーター	名詞
ｽﾃﾗｼﾞｱﾝ	ステラジアン	名詞
ｽﾃﾚｵﾄｳｴｲ	ステレオ投影	名詞
ｽｳﾁﾋﾞﾌﾞﾝﾎｳ	数値微分法	名詞
ｽﾃｨﾌﾈｽ	スティフネス	名詞
ｽﾁｰﾑｴｾﾞｸﾀｰ	スチームエゼクター	名詞
ｽｳﾁｶｲ	数値解	名詞
ｽｳﾁｶｲﾎｳ	数値解法	名詞
ｽｳﾁｹｲｻﾝ	数値計算	名詞
ｽﾁﾙﾌﾞ	スチルブ	名詞
ｽｳﾁｾｷﾌﾞﾝﾎｳ	数値積分法	名詞
ｽﾄｰｸｽ	ストークス	名詞
ｽﾄｰｸｽ	Stokes	人名
ｽﾄｰｸｽﾍﾞｸﾄﾙ	ストークスベクトル	名詞
ｽﾄｰｸｽﾉﾎｳｿｸ	ストークスの法則	名詞
ｽﾄｰｸｽﾉﾎｳﾃｲｼｷ	ストークスの方程式	名詞
ｽﾄｰｸｽﾉｶﾝｹｲｼｷ	ストークスの関係式	名詞
ｽﾄｰｸｽﾉﾅｶﾞﾚﾉｶﾝｽｳ	ストークスの流れの関数	名詞
ｽﾄｰｸｽﾉﾊﾟﾗﾄﾞｯｸｽ	ストークスのパラドックス	名詞
ｽﾄｰｸｽﾉﾃｲﾘ	ストークスの定理	名詞
ｽﾄｰｸｽｾﾝ	ストークス線	名詞
ｽﾄﾅｰﾚｲｷ	ストナー励起	名詞
ｽﾄﾅｰﾘﾛﾝ	ストナー理論	名詞
ｽﾄｰﾝﾉﾃｲﾘ	ストーンの定理	名詞
ｽﾄｯﾌﾟﾊﾞﾝﾄﾞ	ストップバンド	名詞
ｽﾄｯﾌﾟﾄﾞﾌﾛｰ	ストップドフロー	名詞
ｽﾄﾗｸﾞﾘﾝｸﾞ	ストラグリング	名詞
ｽﾄﾚﾑｸﾞﾚﾝｷｭｳ	ストレムグレン球	名詞
ｽﾄﾚﾝｼﾞｸｫｰｸ	ストレンジクォーク	名詞
ｽﾄﾚﾝｼﾞﾈｽ	ストレンジネス	名詞
ｽﾄﾚｰｼﾞｵｼﾄﾞｽｺｰﾌﾟ	ストレージオシロスコープ	名詞
ｽﾄﾘｴｰｼｮﾝ	ストリエーション	名詞
ｽﾄﾘｰｸｶﾒﾗ	ストリークカメラ	名詞
ｽﾄﾘｰﾏｰﾁｪﾝﾊﾞｰ	ストリーマーチェンバー	名詞
ｽﾄﾘｯﾋﾟﾝｸﾞﾊﾝﾉｳ	ストリッピング反応	名詞
ｽﾄﾘｯﾌﾟｾﾝﾛ	ストリップ線路	名詞
ｽﾄﾛﾎﾞｽｺｰﾌﾟ	ストロボスコープ	名詞
ｽﾄﾛｰﾊﾙｽｳ	ストローハル数	名詞
ｽﾂﾙﾑﾎｳ	スツルム法	名詞
ｽﾂﾙﾑﾘｳﾋﾞﾙﾎｳﾃｲｼｷ	スツルム・リウビル方程式	名詞
ｽﾜｰﾙ	スワール	名詞
ｼｬﾀﾞﾝｱｰｸ	遮断アーク	名詞
ｼｬﾀﾞﾝｼｭｳﾊｽｳ	遮断周波数	名詞
ｼｬﾄﾞｳｲﾝｸﾞ	シャドウイング	名詞
ｼｬｴｲｴﾝｻﾞﾝｼ	射影演算子	名詞
ｼｬｴｲｴﾝｻﾞﾝｼﾉﾎｳﾎｳ	射影演算子の方法	名詞
ｼｬﾍｲｺｳｶ	遮蔽効果	名詞
ｼｬﾍｲｺｳｼ	遮蔽格子弧
ｼｬﾍｲﾃｲｽｳ	遮蔽定数	名詞
ｼｬﾍｲｻﾞｲ	遮蔽材	名詞
ｼｬﾎｳｼｮｳｹｲ	斜方晶系	名詞
ｼｬｲﾌﾞﾉﾊﾄﾞｳｼﾞｯｹﾝｷ	シャイブの波動実験器	名詞
ｼｬｺｳﾋﾞｰﾑﾎｳ	斜交ビーム法	名詞
ｼｬｺｳｼｭｳﾀﾞﾝ	斜交集団	名詞
ｼｬﾉﾝﾉﾃｲﾘ	シャノンの定理	名詞
ｼｬﾝﾄｲﾝﾋﾟｰﾀﾞﾝｽ	シャントインピーダンス	名詞
ｼｬﾆｭｳｼｬ	斜入射	名詞
ｼｬﾙﾊﾟｯｸﾁｪﾝﾊﾞｰ	シャルパックチェンバー	名詞
ｼｬﾙﾋﾟｰｼｮｳｹﾞｷｼｹﾝ	シャルピー衝撃試験	名詞
ｼｬﾙﾙﾉﾎｳｿｸ	シャルルの法則	名詞
ｼｬｾﾝ	射線	名詞
ｼｬｾﾝﾋｮｳｹﾞﾝ	射線表現	名詞
ｼｬｼﾝｶﾝﾄﾞ	写真感度	名詞
ｼｬｼﾝﾆｭｳｻﾞｲ	写真乳剤	名詞
ｼｬｼﾝﾄｳｷｭｳ	写真等級	名詞
ｼｬｼｭﾂｾｲｹｲ	射出成形	名詞
ｼｬｰｳｯﾄﾞｽｳ	シャーウッド数	名詞
ｼｬﾜｰｶｳﾝﾀｰ	シャワーカウンター	名詞
ｼｪｲｯｸｱｯﾌﾟ	シェイクアップ	名詞
ｼｪｲｸｵﾌ	シェイクオフ	名詞
ｼｪｰﾝﾍﾞﾙｸｺｳｶ	シェーンベルク効果	名詞
ｼｪｰﾝﾌﾘｰｽﾉｷｺﾞｳ	シェーンフリースの記号	名詞
ｼｪｰﾘﾝｸﾞﾌﾞﾘｯｼﾞ	シェーリングブリッジ	名詞
ｼｪﾙﾂｧｰﾉﾃﾞﾝﾀﾂｶﾝｽｳ	シェルツァーの伝達関数	名詞
ｼｮｱｶﾀｻ	ショア硬さ	名詞
ｼｮｳﾃﾞﾝｷ	焦電気	名詞
ｼｮｳﾄﾞｳ	章動	名詞
ｼｮｳｶﾞｲﾎﾟﾃﾝｼｬﾙ	障害ポテンシャル	名詞
ｼｮｳｹﾞｷｱｯｼｭｸ	衝撃圧縮	名詞
ｼｮｳｹﾞｷﾊｶﾝ	衝撃波管	名詞
ｼｮｳｹﾞｷﾊｶﾈﾂ	衝撃波加熱	名詞
ｼｮｳｹﾞｷﾊﾃｲｺｳ	衝撃波抵抗	名詞
ｼｮｳｹﾞｷｶﾝｽｳ	衝撃関数	名詞
ｼｮｳｹﾞｷｹﾝﾘｭｳｹｲ	衝撃検流計	名詞
ｼｮｳｹﾞｷｷｮｳﾄﾞ	衝撃強度	名詞
ｼｮｳｹﾞｷｵﾝ	衝撃音	名詞
ｼｮｳｹﾞｷｼｹﾝ	衝撃試験	名詞
ｼｮｳｹﾞｷﾁ	衝撃値	名詞
ｼｮｳｸﾞﾝ	小群	名詞
ｼｮｳﾍｲﾒﾝ	焦平面	名詞
ｼｮｳﾍｷ	晶癖	名詞
ｼｮｳﾍｷﾒﾝ	晶癖面	名詞
ｼｮｳﾍﾝﾄﾞ	消偏度	名詞
ｼｮｳｶｸｻﾝﾗﾝ	小角散乱	名詞
ｼｮｳｶﾈﾂ	昇華熱	名詞
ｼｮｳｹｲｶｸﾘｭｳｶｲ	小傾角粒界	名詞
ｼｮｷｲｿｳ	初期位相	名詞
ｼｮｷｵｳﾘｮｸ	初期応力	名詞
ｼｮｷﾁｷｮｳｶｲﾁﾓﾝﾀﾞｲ	初期値-境界値問題	名詞
ｼｮｷﾁﾓﾝﾀﾞｲ	初期値問題	名詞
ｼｮｷｼﾞｮｳｹﾝ	初期条件	名詞
ｼｮｯｸﾚｰﾉﾌﾞﾌﾞﾝﾃﾝｲ	ショックレーの部分転位	名詞
ｼｮｯｸﾚｰｼﾞｭﾝｲ	ショックレー準位	名詞
ｼｮｳｺｳｴﾝｻﾞﾝｼ	昇降演算子	名詞
ｼｮｳｺｳﾎｳ	消光法	名詞
ｼｮｳｺｶｸ	消弧角	名詞
ｼｮｳｺｳｶｸ	消光角	名詞
ｼｮｳｺｳﾘﾂ	消光率	名詞
ｼｮｸﾊﾞｲｻﾖｳ	触媒作用	名詞
ｼｮｸﾍﾝｺｳｾｲ	食変光星	名詞
ｼｮｳｸﾚﾝｾｲ	食連星	名詞
ｼｮｳﾒﾂﾃﾞﾝｲ	消滅電位	名詞
ｼｮｳﾒﾂﾃﾞﾝｲﾎｳ	消滅電位法	名詞
ｼｮｳﾒﾂﾎｳｼｬｾﾝ	消滅放射線	名詞
ｼｮｳﾒﾂｿｸ	消滅則	名詞
ｼｮｳｵﾝﾀﾞﾂﾘﾎｳ	昇温脱離法	名詞
ｼｮｳｻｲﾂﾘｱｲ	詳細釣合い	名詞
ｼｮｳｾｲｼﾞｭﾝﾌﾞﾝﾌﾟ	小正準分布	名詞
ｼｮｳｾｲｼﾞｭﾝｼｭｳﾀﾞﾝ	小正準集団	名詞
ｼｮｳｾﾝ	焦線	名詞
ｼｮｿｸﾄﾞ	初速度	名詞
ｼｮｳｽｲ	消衰	名詞
ｼｮｳｽｲｹｲｽｳ	消衰係数	名詞
ｼｮｳｽｲｺｳｶ	消衰効果	名詞
ｼｮｳｽｲｷｮﾘ	消衰距離	名詞
ｼｮｳｽｲｼﾞﾏ	消衰縞	名詞
ｼｮｳｽｳｷｬﾘﾔｰ	少数キャリヤー	名詞
ｼｮｳｽｳﾉﾎｳｿｸ	小数の法則	名詞
ｼｮｳｼｬｺｳｶ	照射硬化	名詞
ｼｮｳｼｬｾﾝﾘｮｳ	照射線量	名詞
ｼｮｳｼｬｿﾝｼｮｳ	照射損傷	名詞
ｼｮｳｼｭﾂ	晶出	名詞
ｼｮｳﾀｲ	晶帯	名詞
ｼｮｳﾀｲｼﾞｸ	晶帯軸	名詞
ｼｮｳﾃﾝｷｮﾘ	焦点距離	名詞
ｼｮｳﾃﾝﾒﾝ	焦点面	名詞
ｼｮｳﾃﾝｼﾝﾄﾞ	焦点深度	名詞
ｼｮｳﾄﾂﾋﾞｰﾑ	衝突ビーム	名詞
ｼｮｳﾄﾂﾋﾞｰﾑｼﾞｯｹﾝ	衝突ビーム実験	名詞
ｼｮｳﾄﾂﾀﾞﾝﾒﾝｾｷ	衝突断面積	名詞
ｼｮｳﾄﾂﾃﾞﾝﾘ	衝突電離	名詞
ｼｮｳﾄﾂｶﾞﾀｶｿｸｷ	衝突型加速器	名詞
ｼｮｳﾄﾂﾋﾝﾄﾞ	衝突頻度	名詞
ｼｮｳﾄﾂﾋﾛｶﾞﾘ	衝突広がり	名詞
ｼｮｳﾄﾂﾎｳｼｬｻｲｹﾂｺﾞｳ	衝突-放射再結合	名詞
ｼｮｳﾄﾂｶｽｹｰﾄﾞ	衝突カスケード	名詞
ｼｮｳﾄﾂｹｲｽｳ	衝突径数	名詞
ｼｮｳﾄﾂｹｲｽｳﾎｳ	衝突径数法	名詞
ｼｮｳﾄﾂｷｮｳﾄﾞ	衝突強度	名詞
ｼｮｳﾄﾂﾐﾂﾄﾞ	衝突密度	名詞
ｼｮｳﾄﾂｼﾂ	衝突室	名詞
ｼｮｳﾄﾂｼｭｳﾊｽｳ	衝突周波数	名詞
ｼｮﾄｳｼﾞﾘﾂ	初透磁率	名詞
ｼｮｯﾄｷｰ	ショットキー	人名
ｼｮｯﾄｷｰ	Schottky	人名
ｼｮｯﾄｷｰﾊﾞﾘｱｰ	ショットキーバリアー	名詞
ｼｮｯﾄｷｰﾀﾞｲｵｰﾄﾞ	ショットキーダイオード	名詞
ｼｮｯﾄｷｰﾋﾈﾂ	ショットキー比熱	名詞
ｼｮｯﾄｷｰｹｯｶﾝ	ショットキー欠陥	名詞
ｼｮｯﾄｷｰｺｳｶ	ショットキー効果	名詞
ｼｮｯﾄｻﾞﾂｵﾝ	ショット雑音	名詞
ｼｮｳｼﾞ	消磁	名詞
ｼｭｰｱﾉﾎﾀﾞｲ	シューアの補題	名詞
ｼｭﾌﾞﾆｺﾌﾄﾞﾊｰｽｺｳｶ	シュブニコフ・ドハース効果	名詞
ｼｭﾌﾞﾆｺﾌｸﾞﾝ	シュブニコフ群	名詞
ｼｭﾌﾞﾝｻﾝ	主分散	名詞
ｼｭｳﾀﾞﾝﾍｲｷﾝ	集団平均	名詞
ｼｭｳﾀﾞﾝｶｲﾃﾝｳﾝﾄﾞｳ	集団回転運動	名詞
ｼｭｳﾀﾞﾝｺｳｶｶｿｸｷ	集団効果加速器	名詞
ｼｭﾀﾞﾝﾒﾝ	主断面	名詞
ｼｭｳﾀﾞﾝﾓｹｲ	集団模型	名詞
ｼｭｳﾀﾞﾝﾚｲｷ	集団励起	名詞
ｼｭｳﾀﾞﾝｼﾝﾄﾞｳ	集団振動	名詞
ｼｭｳﾀﾞﾝｳﾝﾄﾞｳ	集団運動	名詞
ｼｭｳﾀﾞﾝｻﾞﾋｮｳ	集団座標	名詞
ｼｭｳｴﾝｹﾞﾝｺｳ	周縁減光	名詞
ｼｭｳｸﾞﾝｻﾖｳ	集群作用	名詞
ｼｭｳﾊｽｳｱﾝﾃｲｶ	周波数安定化	名詞
ｼｭｳﾊｽｳﾌﾞﾝｾｷ	周波数分析	名詞
ｼｭｳﾊｽｳﾌﾞﾝｾｷｷ	周波数分析器	名詞
ｼｭｳﾊｽｳﾃﾞﾝﾀﾂｶﾝｽｳ	周波数伝達関数	名詞
ｼｭｳﾊｽｳﾍﾝｶﾝｷ	周波数変換機	名詞
ｼｭｳﾊｽｳﾍﾝﾁｮｳ	周波数変調	名詞
ｼｭｳﾊｽｳｶｳﾝﾀｰ	周波数カウンター	名詞
ｼｭｳﾊｽｳｹｲ	周波数計	名詞
ｼｭｳﾊｽｳｽﾍﾟｸﾄﾙ	周波数スペクトル	名詞
ｼｭｳﾊｽｳﾀｲ	周波数帯	名詞
ｼｭｳﾊｽｳﾃｲﾊﾞｲｷ	周波数逓倍器	名詞
ｼｭｳﾊｽｳﾄｸｾｲ	周波数特性	名詞
ｼｭﾊﾁｮｳ	主波長	名詞
ｼｭﾍｲﾒﾝ	主平面	名詞
ｼｭﾋｽﾞﾐ	主ひずみ	名詞
ｼｭｶﾝｾｲﾓｰﾒﾝﾄ	主慣性モーメント	名詞
ｼｭｹｲﾚﾂ	主系列	名詞
ｼｭｹｲﾚﾂｾｲ	主系列星	名詞
ｼｭｳｷﾊﾞ	周期場	名詞
ｼｭｳｷﾋｮｳ	周期表	名詞
ｼｭｳｷﾘﾂ	周期律	名詞
ｼｭｳｷﾃｷﾎﾟﾃﾝｼｬﾙ	周期的ポテンシャル	名詞
ｼｭｳｷﾃｷｿﾞｰﾝ	周期的ゾーン	名詞
ｼｭｳｷｳﾝﾄﾞｳ	周期運動	名詞
ｼｭｺｳｶﾞｸｼﾞｸ	主光学軸	名詞
ｼｭｳｺｳｷ	集光器	名詞
ｼｭｳｺｳﾚﾝｽﾞ	集光レンズ	名詞
ｼｭｺｳｾﾝ	主光線	名詞
ｼｭｸﾘｭｳ	縮流	名詞
ｼｭｸｯｾﾂﾘﾂ	主屈折率	名詞
ｼｭｸﾀｲ	縮退	名詞
ｼｭｸﾀｲｶﾞﾀﾊﾝﾄﾞｳﾀｲ	縮退型半導体	名詞
ｼｭｸﾀｲｷﾀｲ	縮退気体	名詞
ｼｭｸﾀｲｵﾝﾄﾞ	縮退温度	名詞
ｼｭｸﾀｲｾｲ	縮退星	名詞
ｼｭｸﾔｸ	縮約	名詞
ｼｭｰﾏﾝｶﾝﾊﾟﾝ	シューマン乾板	名詞
ｼｭｰﾏﾝﾘｮｳｲｷ	シューマン領域	名詞
ｼｭﾐｯﾄ	シュミット	人名
ｼｭﾐｯﾄ	Schmidt	人名
ｼｭﾐｯﾄﾎﾞｳｴﾝｷｮｳ	シュミット望遠鏡	名詞
ｼｭﾐｯﾄｲﾝｼ	シュミット因子	名詞
ｼｭﾐｯﾄｶﾒﾗ	シュミットカメラ	名詞
ｼｭﾐｯﾄﾉﾎｳｿｸ	シュミットの法則	名詞
ｼｭﾐｯﾄｾﾝ	シュミット線	名詞
ｼｭﾐｯﾄｽｳ	シュミット数	名詞
ｼｭﾐｯﾄﾁ	シュミット値	名詞
ｼｭﾝﾌﾞﾝﾃﾝ	春分点	名詞
ｼｭﾝｶﾝｶｿｸﾄﾞ	瞬間加速度	名詞
ｼｭﾝｶﾝｷﾝｼﾞ	瞬間近似	名詞
ｼｭﾝｶﾝｿｸﾄﾞ	瞬間速度	名詞
ｼｭﾝｼﾞﾃﾞﾝﾘｮｸ	瞬時電力	名詞
ｼｭﾝｼﾞｶｲﾃﾝｼﾞｸ	瞬時回転軸	名詞
ｼｭｵｳﾘｮｸ	主応力	名詞
ｼｭﾚｰﾃﾞｨﾝｶﾞｰ	シュレーディンガー	人名
ｼｭﾚｰﾃﾞｨﾝｶﾞｰ	Schrodinger	人名
ｼｭﾚｰﾃﾞｨﾝｶﾞｰ	Schr\"{o}dinger	人名
ｼｭﾚﾃﾞｨﾝｶﾞｰ	シュレーディンガー	人名
ｼｭﾚﾃﾞｨﾝｶﾞｰ	Schrodinger	人名
ｼｭﾚﾃﾞｨﾝｶﾞｰ	Schr\"{o}dinger	人名
ｼｭﾚｰﾃﾞｨﾝｶﾞｰﾋｮｳｼﾞ	シュレーディンガー表示	名詞
ｼｭﾚﾃﾞｨﾝｶﾞｰﾋｮｳｼﾞ	シュレーディンガー表示	名詞
ｼｭﾚｰﾃﾞｨﾝｶﾞｰﾉﾈｺ	シュレーディンガーの猫	名詞
ｼｭﾚﾃﾞｨﾝｶﾞｰﾉﾈｺ	シュレーディンガーの猫	名詞
ｼｭﾘｰﾚﾝﾎｳ	シュリーレン法	名詞
ｼｭﾘｰﾚﾝｽﾞｹｲ	シュリーレン図形	名詞
ｼｭﾙﾂｹﾞｰｼﾞ	シュルツゲージ	名詞
ｼｭﾙﾂﾎｳ	シュルツ法	名詞
ｼｭﾘｮｳｼｽｳ	主量子数	名詞
ｼｭｳｾｷｶｲﾛ	集積回路	名詞
ｼｭｳｾｷﾃﾝ	集積点	名詞
ｼｭｾﾝﾀﾞﾝｵｳﾘｮｸ	主せん断応力	名詞
ｼｭｳｿｸﾃﾞﾝｼｾﾝｶｲｾﾂ	集束電子線回折	名詞
ｼｭｳｿｸﾄﾞ	終速度	名詞
ｼｭｳｿｸｻﾖｳ	集束作用	名詞
ｼｭｯｼｬﾋﾄﾐ	出射ひとみ	名詞
ｼｭｳﾀﾝｿｸﾄﾞ	終端速度	名詞
ｼｭﾀﾙｸ	シュタルク	人名
ｼｭﾀﾙｸ	Stark	人名
ｼｭﾀﾙｸﾌﾞﾝｺｳﾎｳ	シュタルク分光法	名詞
ｼｭﾀﾙｸｺｳｶ	シュタルク効果	名詞
ｼｭﾀﾙｸﾗﾀﾞｰ	シュタルクラダー	名詞
ｼｭﾀﾙｸｽｲｯﾁﾎｳ	シュタルクスイッチ法	名詞
ｼｭﾀｳﾃﾞｨﾝｶﾞｰﾉｽﾞ	シュタルディンガー・野津	人名
ｼｭﾃﾌｧﾝﾎﾞﾙﾂﾏﾝ	シュテファン・ボルツマン	人名
ｼｭﾃﾌｧﾝﾎﾞﾙﾂﾏﾝﾃｲｽｳ	シュテファン・ボルツマン定数	名詞
ｼｭｳﾃﾝｴﾝ	周転円	名詞
ｼｭﾃﾙﾏｰﾘﾛﾝ	シュテルマー理論	名詞
ｼｭﾃﾙﾝｹﾞﾙﾗｯﾊ	シュテルン・ゲルラッハ	人名
ｼｭﾁ	主値	名詞
ｼｭﾂｹﾞﾝﾃﾞﾝｱﾂ	出現電圧	名詞
ｼｭﾂﾘｮｸﾍﾝｾｲｷ	出力変成器	名詞
ｼｭﾂﾘｮｸｲﾝﾋﾟｰﾀﾞﾝｽ	出力インピーダンス	名詞
ｼｭｳﾁｬｸ	収着	名詞
ｼｭﾃｭｯｹﾙﾍﾞﾙｸｼﾝﾄﾞｳ	シュテュッケルベルク振動	名詞
ｼｭｳﾁｭｳﾃｲｽｳｶｲﾛ	集中定数回路	名詞
ｼｭﾜﾙﾂﾉﾌﾄｳｼｷ	シュワルツの不等式	名詞
ｼｭﾜﾙﾂｼﾙﾄﾊﾝｹｲ	シュワルツシルト半径	名詞
ｼｭｳｨﾝｶﾞｰｶﾝｽｳ	シュウィンガー関数	名詞
ｼｭｳｨﾝｶﾞｰﾓｹｲ	シュウィンガー模型	名詞
ｼｭｼﾞｸﾍﾝｶﾝ	主軸変換	名詞
ｼｭｳｼﾞｮｳﾀｲ	終状態	名詞
ｼｭｼﾞｮｳﾀｲｿｳｺﾞｻﾖｳ	終状態相互作用	名詞
ｼｰﾀｵﾝﾄﾞ	θ温度	名詞
ｼｰﾀｵﾝﾄﾞ	$\theta$温度	名詞
ｼｰﾀｵﾝﾄﾞ	\theta温度	名詞
ﾃｰﾀｵﾝﾄﾞ	θ温度	名詞
ﾃｰﾀｵﾝﾄﾞ	$\theta$温度	名詞
ﾃｰﾀｵﾝﾄﾞ	\theta温度	名詞
ｾｰﾀｵﾝﾄﾞ	θ温度	名詞
ｾｰﾀｵﾝﾄﾞ	$\theta$温度	名詞
ｾｰﾀｵﾝﾄﾞ	\theta温度	名詞
ｼｰﾀﾋﾟﾝﾁ	θピンチ	名詞
ｼｰﾀﾋﾟﾝﾁ	$\theta$ピンチ	名詞
ｼｰﾀﾋﾟﾝﾁ	\thetaピンチ	名詞
ﾃｰﾀﾋﾟﾝﾁ	θピンチ	名詞
ﾃｰﾀﾋﾟﾝﾁ	$\theta$ピンチ	名詞
ﾃｰﾀﾋﾟﾝﾁ	\thetaピンチ	名詞
ｾｰﾀﾋﾟﾝﾁ	θピンチ	名詞
ｾｰﾀﾋﾟﾝﾁ	$\theta$ピンチ	名詞
ｾｰﾀﾋﾟﾝﾁ	\thetaピンチ	名詞
ｼｰﾀﾀｳﾊﾟｽﾞﾙ	θ-τパズル	名詞
ｼｰﾀﾀｳﾊﾟｽﾞﾙ	$\theta-\tau$パズル	名詞
ｼｰﾀﾀｳﾊﾟｽﾞﾙ	\theta-\tauパズル	名詞
ﾃｰﾀﾀｳﾊﾟｽﾞﾙ	θ-τパズル	名詞
ﾃｰﾀﾀｳﾊﾟｽﾞﾙ	$\theta-\tau$パズル	名詞
ﾃｰﾀﾀｳﾊﾟｽﾞﾙ	\theta-\tauパズル	名詞
ｾｰﾀﾀｳﾊﾟｽﾞﾙ	θ-τパズル	名詞
ｾｰﾀﾀｳﾊﾟｽﾞﾙ	$\theta-\tau$パズル	名詞
ｾｰﾀﾀｳﾊﾟｽﾞﾙ	\theta-\tauパズル	名詞
Tｸｫｰｸ	tクォーク	名詞
Tﾁｬﾈﾙ	tチャネル	名詞
TVｷｮｸｾﾝ	T-V曲線	名詞
ﾀｰﾎﾞﾌﾞﾝｼﾎﾟﾝﾌﾟ	ターボ分子ポンプ	名詞
ﾀﾌﾞﾝｻﾝｹｲ	多分散系	名詞
ﾀﾌﾞﾝｼｾｲ	多分子性	名詞
ﾀﾌﾞﾝｼｿｳ	多分子層	名詞
ﾀｹﾞﾝｼﾌﾞﾝｼ	多原子分子	名詞
ﾀｷﾞﾝｸﾞ	タギング	名詞
ﾀｸﾞﾝｶｸｻﾝﾘﾛﾝ	多群拡散理論	名詞
ﾀﾊｷﾝｼﾞ	多波近似	名詞
ﾀｲﾊﾞﾝ	帯板	名詞
ﾀｲﾎﾞｳﾁｮｳｹｲｽｳ	体膨張係数	名詞
ﾀｲﾎﾞｳﾁｮｳﾘﾂ	体膨張率	名詞
ﾀｲﾌﾞﾂｷｮｳ	対物鏡	名詞
ﾀｲﾌﾞﾂﾚﾝｽﾞ	対物レンズ	名詞
ﾀｲﾃﾞﾝｱﾂ	耐電圧	名詞
ﾀｲﾃﾞﾝｷｮｸ	対電極	名詞
ﾀｲﾃﾞﾝﾀｲ	帯電体	名詞
ﾀｲｸﾞﾝ	帯群	名詞
ﾀｲﾎｳｼｬｾﾝｾｲ	対放射線性	名詞
ﾀｲｲｷ	帯域	名詞
ﾀｲｲｷﾌｨﾙﾀｰ	帯域フィルター	名詞
ﾀｲｲｷﾊﾊﾞ	帯域幅	名詞
ﾀｲｲｷﾂｳｶﾌｨﾙﾀｰ	帯域通過フィルター	名詞
ﾀｲｶﾌﾞﾂ	耐火物	名詞
ﾀｲｶｸｸﾞﾝ	対角群	名詞
ﾀｲｶｸｶ	対角化	名詞
ﾀｲｶｸﾖｳｿ	対角要素	名詞
ﾀｲｹｲ	帯系	名詞
ﾀｲｷﾊﾄﾞｳ	大気波動	名詞
ﾀｲｷﾎｳｼｬ	大気放射	名詞
ﾀｲｷｲｵﾝ	大気イオン	名詞
ﾀｲｷｺｳ	大気光	名詞
ﾀｲｷｻ	大気差	名詞
ﾀｲｺｳﾃﾞﾝｷｮｸ	対向電極	名詞
ﾀｲｷｭｳｶﾝｽｳ	体球関数	名詞
ﾀｲﾑﾌﾟﾛｼﾞｪｸｼｮﾝ	タイムプロジェクション	名詞
ﾁｪﾝﾊﾞｰ	チェンバー	名詞
ﾀｲｵｳｹﾞﾝﾘ	対応原理	名詞
ﾀｲｵｳﾘｭｳｶｲ	対応粒界	名詞
ﾀｲｵｳｽﾞ	対応図	名詞
ﾀｲﾚﾂ	帯列	名詞
ﾀｲﾘｸｲﾄﾞｳｾﾂ	大陸移動説	名詞
ﾀｲﾘｭｳﾃﾞﾝﾘｭｳ	対流電流	名詞
ﾀｲﾘｭｳﾌｱﾝﾃｲ	対流不安定	名詞
ﾀｲﾘｭｳｶｸｻﾝ	対流拡散	名詞
ﾀｲﾘｭｳｿｳ	対流層	名詞
ﾀｲﾘｭｳｼﾞｶﾝ	滞留時間	名詞
ﾀｲｾｲｾｲﾎｳ	帯精製法	名詞
ﾀｲｾｷﾎﾞｳﾁｮｳﾘﾂ	体積膨張率	名詞
ﾀｲｾｷﾀﾞﾝｾｲﾘﾂ	体積弾性率	名詞
ﾀｲｾｷｴﾈﾙｷﾞｰ	体積エネルギー	名詞
ﾀｲｾｷﾋｽﾞﾐ	体積ひずみ	名詞
ﾀｲｾｷﾎﾛｸﾞﾗﾑ	体積ホログラム	名詞
ﾀｲｾｷｶﾝﾜ	体積緩和	名詞
ﾀｲｾｷﾐﾂﾄﾞ	体積密度	名詞
ﾀｲｾｷﾈﾝｾｲﾘﾂ	体積粘性率	名詞
ﾀｲｾｷﾘｮｸ	体積力	名詞
ﾀｲｾｷﾘｭｳﾘｮｳｹｲ	体積流量計	名詞
ﾀｲｾｷｿｸﾄﾞ	体積速度	名詞
ﾀｲｾｷﾃｲｺｳﾘﾂ	体積抵抗率	名詞
ﾀｲｼﾝｺｳｼ	体心格子	名詞
ﾀｲｼﾝﾘｯﾎﾟｳｺｳｿﾞｳ	体心立方構造	名詞
ﾀｲｽｳﾋﾞﾌﾞﾝ	対数微分	名詞
ﾀｲｽｳｹﾞﾝｽｲﾘﾂ	対数減衰率	名詞
ﾀｲｽｳﾋｽﾞﾐ	対数ひずみ	名詞
ﾀｲｽｳﾉﾎｳｿｸ	大数の法則	名詞
ﾀｲｽﾍﾟｸﾄﾙ	帯スペクトル	名詞
ﾀｲｽｳｿﾞｳﾌｸｷ	対数増幅器	名詞
ﾀｲｼｮｳｴﾈﾙｷﾞｰ	対称エネルギー	名詞
ｳﾝﾄﾞｳﾘｮｳﾃﾝｿﾙ	運動量テンソル	名詞
ﾀｲｼｮｳｸﾞﾝ	対称群	名詞
ﾀｲｼｮｳｶｲﾃﾝｼﾞｭﾝｲ	対称回転準位	名詞
ﾀｲｼｮｳｶｷﾄﾞｳ	対称化軌道	名詞
ﾀｲｼｮｳｶｸﾌﾞﾝﾚﾂ	対称核分裂	名詞
ﾀｲｼｮｳｷﾄﾞｳ	対称軌道	名詞
ﾀｲｼｮｳｷﾄﾞｳｶﾝｽｳ	対称軌道関数	名詞
ﾀｲｼｮｳｺﾏ	対称こま	名詞
ﾀｲｼｮｳｺﾏﾌﾞﾝｼ	対称こま分子	名詞
ﾀｲｼｮｳｺﾏｶﾞﾀﾌﾞﾝｼ	対称こま形分子	名詞
ﾀｲｼｮｳﾎﾟﾃﾝｼｬﾙ	対称ポテンシャル	名詞
ﾀｲｼｮｳｾｲ	対称性	名詞
ﾀｲｼｮｳｾｲﾉﾔﾌﾞﾚ	対称性の破れ	名詞
ｼﾞﾊﾂﾃｷﾔﾌﾞﾚ	自発的破れ	名詞
ﾀｲｼｮｳｼﾝ	対称心	名詞
ﾀｲｼｮｳｿｳｻｸﾞﾝ	対称操作群	名詞
ﾀｲｼｮｳﾃﾝｿﾙ	対称テンソル	名詞
ﾀｲｼｮｳﾁｭｳｼﾝ	対称中心	名詞
ﾀｲｼｮｳﾖｳｿ	対称要素	名詞
ﾀｲﾄｳ	帯頭	名詞
ﾀｲﾖｳﾌﾞﾂﾘｶﾞｸ	太陽物理学	名詞
ﾀｲﾖｳﾃﾞﾝﾊﾟ	太陽電波	名詞
ﾀｲﾖｳﾃﾞﾝﾁ	太陽電池	名詞
ﾀｲﾖｳﾃﾞﾝﾁｿｼ	太陽電池素子	名詞
ﾀｲﾖｳｴﾈﾙｷﾞｰ	太陽エネルギー	名詞
ﾀｲﾖｳﾎｳｼｬ	太陽放射	名詞
ﾀｲﾖｳﾌｳ	太陽風	名詞
ﾀｲﾖｳﾌﾚｱ	太陽フレア	名詞
ﾀｲﾖｳｶﾂﾄﾞｳ	太陽活動	名詞
ﾀｲﾖｳｶﾂﾄﾞｳｼｭｳｷ	太陽活動周期	名詞
ﾀｲﾖｳｺｸﾃﾝ	太陽黒点	名詞
ﾀｲﾖｳｺﾛﾅ	太陽コロナ	名詞
ﾀｲﾖｳﾒﾝﾊﾞｸﾊﾂ	太陽面爆発	名詞
ﾀｲﾖｳﾈﾝ	太陽年	名詞
ﾀｲﾖｳﾆｭｰﾄﾘﾉ	太陽ニュートリノ	名詞
ﾀｲﾖｳﾛ	太陽炉	名詞
ﾀｲﾖｳｽﾍﾟｸﾄﾙ	太陽スペクトル	名詞
ﾀｲﾖｳﾃｲｽｳ	太陽定数	名詞
ﾀｲﾖｳｳﾁｭｳｾﾝ	太陽宇宙線	名詞
ﾀｲﾖｳXｾﾝ	太陽X線	名詞
ﾀｲﾖｳｻﾞﾂｵﾝ	太陽雑音	名詞
ﾀｲﾖｳｼﾞﾊﾞ	太陽磁場	名詞
ﾀｲｻﾞｲｼﾞｶﾝ	滞在時間	名詞
ﾀｶｷﾞﾄｰﾊﾟﾝﾉｼｷ	高木・トーパンの式	名詞
ﾀｶｲｵﾝ	多価イオン	名詞
ﾀｹｲ	多形	名詞
ﾀｹｯｼｮｳﾀｲ	多結晶体	名詞
ﾀｷｵﾝ	タキオン	名詞
ﾀｺｳﾌﾞﾝﾌﾟ	多項分布	名詞
ﾀｺｳﾘﾂ	多孔率	名詞
ﾀｺｳｼｶｲﾘ	多光子解離	名詞
ﾀｺｳｼｷｭｳｼｭｳ	多光子吸収	名詞
ﾀｺｳｼｾﾝｲ	多光子遷移	名詞
ﾀｺｳｿｸｶﾝｼｮｳ	多光束干渉	名詞
ﾀｸﾁｼﾃｨ	タクチシティ	名詞
ﾀｷｮｸ	多極	連体詞
ﾀｷｮｸﾃﾞﾝｼﾞｼｬｸ	多極電磁石	名詞
ﾀｷｮｸﾎｳｼｬ	多極放射	名詞
ﾀｷｮｸｼ	多極子	名詞
ﾀｷｮｸﾃﾝｶｲ	多極展開	名詞
ﾀｼﾞｭｳｷｮｸﾃﾝｶｲ	多重極展開	名詞
ﾀｷｮｸｼﾞﾊﾞ	多極磁場	名詞
ﾀﾒｺﾐｼｷﾎﾟﾝﾌﾟ	ため込み式ポンプ	名詞
ﾀﾓｰﾄﾞ	多モード	名詞
ﾀﾑﾀﾞﾝｺﾌｷﾝｼﾞ	タム・ダンコフ近似	名詞
ﾀﾑｼﾞｭﾝｲ	タム準位	名詞
ﾀﾝｱﾝﾃｲ	単安定	連体詞
ﾀﾝﾌﾞﾝｻﾝｹｲ	単分散系	名詞
ﾀﾝﾌﾞﾝｻﾝﾎﾟﾘﾏｰ	単分散ポリマー	名詞
ﾀﾝﾌﾞﾝｼﾊﾝﾉｳ	単分子反応	名詞
ﾀﾝﾌﾞﾝｼﾏｸ	単分子膜	名詞
ﾀﾝﾌﾞﾝｼｿｳ	単分子層	名詞
ﾀﾝﾃﾞﾑｶﾞﾀ	タンデム型	連体詞
ﾀﾝﾃﾞﾑﾐﾗｰ	タンデムミラー	名詞
ﾀﾝｶﾞｰｾｲﾘｭｳｶﾝ	タンガー整流管	名詞
ﾀﾝｹﾞﾝｼﾌﾞﾝｼ	単原子分子	名詞
ﾀﾝｹﾞﾝｼｿｳ	単原子層	名詞
ﾀﾝﾌﾘｺ	単振り子	名詞
ﾀﾝｲﾍﾞｸﾄﾙ	単位ベクトル	名詞
ﾀﾆﾌｫﾙﾃﾞｨﾍﾝｶﾝ	谷・フェルディ変換	名詞
ﾀﾝｲﾎｳ	単位胞	名詞
ﾀﾝｲｺｳｼ	単位格子	名詞
ﾀﾝｲｾﾙ	単位セル	名詞
ﾀﾝｲﾂﾊﾁｮｳﾚｰｻﾞｰ	単一波長レーザー	名詞
ﾀﾝｲﾂﾓｰﾄﾞ	単一モード	名詞
ﾀﾝｲﾂｿｳ	単一層	名詞
ﾀﾝｲﾂｼｭｳﾊｽｳﾚｰｻﾞｰ	単一周波数レーザー	名詞
ﾀﾝｶｶﾙｼｳﾑｶﾞﾀｺｳｿﾞｳ	炭化カルシウム型構造	名詞
ﾀﾝｹﾂｺﾞｳ	単結合	名詞
ﾀﾝｷｮｸｾﾝｲ	単極遷移	名詞
ﾀﾝｷｮｸｼ	単極子	名詞
ﾀﾝｷｮｸｼﾓｰﾒﾝﾄ	単極子モーメント	名詞
ﾀﾝｷｮｸﾕｳﾄﾞｳ	単極誘導	名詞
ﾀﾝｷｮﾘｷｿｸﾄﾞ	短距離規則度	名詞
ﾀﾝｷｮﾘｿｳｶﾝ	短距離相関	名詞
ﾀﾝｷｮﾘﾁﾂｼﾞｮ	短距離秩序	名詞
ﾀﾝﾏｷﾍﾝｱﾂｷ	単巻変圧器	名詞
ﾀﾝｵﾝﾒｲﾘｮｳﾄﾞ	単音明りょう度	名詞
ﾀﾝｵﾝｾﾂﾒｲﾘｮｳﾄﾞ	単音節明りょう度	名詞
ﾀﾝﾊﾟｸｺｳ	たんぱく光	名詞
ﾀﾝﾗｸﾀﾝ	短絡端	名詞
ﾀﾝﾘｮｳﾀｲ	単量体	名詞
ﾀﾝｻﾝﾚｰｻﾞｰ	炭酸レーザー	名詞
ﾀﾝｻﾝｶﾞｽﾚｰｻﾞｰ	炭酸ガスレーザー	名詞
ﾀﾝｾﾂｺﾞｳﾄﾗﾝｼﾞｽﾀｰ	単接合トランジスター	名詞
ﾀﾝｼﾝ	探針	名詞
ﾀﾝｼﾝﾄﾞｳ	単振動	名詞
ﾀﾝｿｳ	単相	名詞
ﾀﾝｿﾏｸﾃｲｺｳ	炭素膜抵抗	名詞
ﾀﾝｿﾋﾏｸﾃｲｺｳ	炭素皮膜抵抗	名詞
ﾀﾝｿﾈﾝﾀﾞｲｿｸﾃｲ	炭素年代測定	名詞
ﾀﾝｿｻｲｸﾙ	炭素サイクル	名詞
ﾀﾝｿﾃｲｺｳｵﾝﾄﾞｹｲ	炭素抵抗温度計	名詞
ﾀﾝｼｬｼｮｳｹｲ	単斜晶系	名詞
ﾀﾝｼｮｸｶ	単色化	名詞
ﾀﾝｼｮｸｺｳ	単色光	名詞
ﾀﾝｼｮｸｺｳｶ	淡色効果	名詞
ﾀﾝｼｮｸｾｲ	単色性	名詞
ﾀﾝﾀｲ	担体	名詞
ﾀﾝｼﾞｸｵｳﾘｮｸ	単軸応力	名詞
ﾀﾝｼﾞｷｮｸ	単磁極	名詞
ﾀﾝｼﾞﾁｮｳ	単耳聴	名詞
ﾀﾝｼﾞｭﾝﾊﾘ	単純はり	名詞
ﾀﾝｼﾞｭﾝｺｳｼ	単純格子	名詞
ﾀﾝｼﾞｭﾝﾘｯﾎﾟｳｺｳｼ	単純立方格子	名詞
ﾀﾝｼﾞｭﾝﾘｯﾎﾟｳｺｳｿﾞｳ	単純立方構造	名詞
ﾀﾚｲｼﾝﾄﾞｳｶｲﾛ	他励振動回路	名詞
ﾀﾘｭｳｼｿｳｶﾝ	多粒子相関	名詞
ﾀｾﾝｽﾍﾟｸﾄﾙ	多線スペクトル	名詞
ﾀｿｳﾀﾞﾝﾈﾂ	多層断熱	名詞
ﾀｿｳﾍｲｺｳ	多相平衡	名詞
ﾀｿｳｺｳﾘｭｳ	多相交流	名詞
ﾀｿｳﾏｸ	多層膜	名詞
ﾀｽｳｷｬﾘﾔｰ	多数キャリヤー	名詞
ﾀﾀｲﾓﾝﾀﾞｲ	多体問題	名詞
ﾀﾀｲﾘｮｸ	多体力	名詞
ﾀﾀｲﾘｭｳｼｿｳｶﾝ	多体粒子相関	名詞
ﾀﾀｲｿｳｶﾝ	多体相関	名詞
ﾀﾀﾐｺﾐ	たたみこみ	名詞
ﾀﾃｶﾞﾀﾃﾞﾝｶｲｺｳｶ	縦型電界効果	連体詞
ﾀﾃﾍﾝｷｮｸ	縦偏極	名詞
ﾀﾃﾋｽﾞﾐ	縦ひずみ	名詞
ﾀﾃｶﾝﾜ	縦緩和	名詞
ﾀﾃﾓｰﾄﾞ	縦モード	名詞
ﾀﾃﾅﾐｺｳｼ	縦波光子	名詞
ﾀﾃｼﾝﾄﾞｳ	縦振動	名詞
ﾀﾃﾕﾚﾓｰﾒﾝﾄ	縦ゆれモーメント	名詞
ﾀﾃｻﾞﾋｮｳ	縦座標	名詞
ﾀﾁｱｶﾞﾘｼﾞｶﾝ	立上がり時間	名詞
ﾀｳﾝｾﾞﾝﾄﾞ	タウンゼンド	名詞
ﾀｳﾝｾﾞﾝﾄﾞﾎｳﾃﾞﾝ	タウンゼンド放電	名詞
ﾀﾜﾐﾉﾁｭｳｼﾝ	たわみの中心	名詞
ﾀﾜﾐｾｲ	たわみ性	名詞
ﾀﾜﾐﾁｭｳｼﾝ	たわみ中心	名詞
ﾀﾖｳﾀｲ	多様体	名詞
ﾀｼﾞｶﾝﾘﾛﾝ	多時間理論	名詞
ﾀｼﾞｸｵｳﾘｮｸ	多軸応力	名詞
ﾀｿﾞｳ	多像	名詞
ﾀｼﾞｭｳﾃﾞﾝﾘ	多重電離	名詞
ﾀｼﾞｭｳﾄﾞ	多重度	名詞
ﾀｼﾞｭｳﾊｺｳﾌﾞﾝｾｷｷ	多重波高分析器	名詞
ﾀｼﾞｭｳﾊﾝｷｮｳ	多重反響	名詞
ﾀｼﾞｭｳﾊﾝｼｬ	多重反射	名詞
ﾀｼﾞｭｳﾊｯｾｲ	多重発生	名詞
ﾀｼﾞｭｳｶｲｾﾂ	多重回折	名詞
ﾀｼﾞｭｳｹﾂｺﾞｳ	多重結合	名詞
ﾀｼﾞｭｳｺｳ	多重項	名詞
ﾀｼﾞｭｳｺｳｷｮｳﾄﾞ	多重項強度	名詞
ﾀｼﾞｭｳｸｯｾﾂ	多重屈折	名詞
ﾀｼﾞｭｳｷｮｸ	多重極	連体詞
ﾀｼﾞｭｳﾆｭｳｼｬ	多重入射	名詞
ﾀｼﾞｭｳﾘﾝｶｲﾃﾝ	多重臨界点	名詞
ﾀｼﾞｭｳﾘｭｳｼﾊｯｾｲ	多重粒子発生	名詞
ﾀｼﾞｭｳｻﾝﾗﾝ	多重散乱	名詞
ﾀｼﾞｭｳｾﾝ	多重線	名詞
ﾀｼﾞｭｳｾﾝｾｲﾌﾞﾝ	多重線成分	名詞
ﾀｼﾞｭｳｿｳｼｮｳﾘｭｳｼ	多重双晶粒子	名詞
ﾀｼﾞｭｳｼｭｳｷｳﾝﾄﾞｳ	多重周期運動	名詞
ﾀｼﾞｭｳﾁｬﾈﾙ	多重チャネル	名詞
ﾃｱｼﾓﾆﾀｰ	手足モニター	名詞
ﾃｲｱﾂﾋﾈﾂ	定圧比熱	名詞
ﾃｲｱﾂｷﾀｲｵﾝﾄﾞｹｲ	定圧気体温度計	名詞
ﾃｲｱﾂﾓﾙﾋﾈﾂ	定圧モル比熱	名詞
ﾃｲﾃﾞﾝｱﾂｱｰｸ	低電圧アーク	名詞
ﾃｲﾃﾞﾝｱﾂﾀﾞｲｵｰﾄﾞ	定電圧ダイオード	名詞
ﾃｲﾃﾞﾝｱﾂﾃﾞﾝｹﾞﾝ	定電圧電源	名詞
ﾃｲﾃﾞﾝｱﾂﾍﾝｱﾂｷ	定電圧変圧器	名詞
ﾃｲﾃﾞﾝｱﾂﾎｳﾃﾞﾝｶﾝ	定電圧放電管	名詞
ﾃｲﾃﾞﾝﾘｭｳﾃﾞﾝｹﾞﾝ	定電流電源	名詞
ﾃｲｹﾞﾝｾﾂﾄﾞｳﾛﾝ	逓減摂動論	名詞
ﾃｲｷﾞﾃｲﾃﾝ	定義定点	名詞
ﾃｲﾍﾝｶｸﾓﾉｸﾛﾒｰﾀｰ	定偏角モノクロメーター	名詞
ﾃｲﾍﾝｶｸﾌﾟﾘｽﾞﾑ	定偏角プリズム	名詞
ﾃｲﾋﾚｲﾉﾎｳｿｸ	定比例の法則	名詞
ﾃｲｲｷｺﾝｾｲｷｮｳﾒｲ	低域混成共鳴	名詞
ﾃｲｲｿｳﾒﾝ	定位相面	名詞
ﾃｲｺｳｹﾞﾝｽｲｷ	抵抗減衰器	名詞
ﾃｲｺｳｵﾝﾄﾞｹｲ	抵抗温度計	名詞
ﾃｲｺｳﾖｳﾘｮｳｹﾂｺﾞｳ	抵抗容量結合	名詞
ﾃｲｼﾝｺｳｼ	底心格子	名詞
ﾃｲﾒﾝｼﾝｺｳｼ	底面心格子	名詞
ﾃｲｵﾝﾌﾞﾂﾘｶﾞｸ	低温物理学	名詞
ﾃｲｵﾝｿｳ	低温槽	名詞
ﾃｲﾗｰ	テイラー	人名
ﾃｲﾗｰ	Taylor	人名
ﾃｲﾗｰｷｭｳｽｳ	テイラー級数	名詞
ﾃｲﾗｰﾉﾅｶﾞﾚ	テイラーの流れ	名詞
ﾃｲﾗｰｽｳ	テイラー数	名詞
ﾃｲﾗｰﾃﾝｶｲ	テイラー展開	名詞
ﾃｲﾚﾍﾞﾙｶｳﾝﾀｰ	低レベルカウンター	名詞
ﾃｲﾘｮｳﾌﾞﾝｾｷ	定量分析	名詞
ﾃｲｾｲﾌﾞﾝｾｷ	定性分析	名詞
ﾃｲｾｷﾍﾝｶ	定積変化	名詞
ﾃｲｾｷﾋﾈﾂ	定積比熱	名詞
ﾃｲｾｷｷﾀｲｵﾝﾄﾞｹｲ	定積気体温度計	名詞
ﾃｲｾｷﾓﾙﾋﾈﾂ	定積モル比熱	名詞
ﾃｲｾﾝﾘｮｳﾋﾊﾞｸ	低線量被爆	名詞
ﾃｲｾﾝﾘｮｳｼｮｳｼｬ	低線量照射	名詞
ﾃｲｿｸﾃﾞﾝｼｶｲｾﾂ	低速電子回折	名詞
ﾃｲｿｸﾃﾞﾝｼｾﾝｶｲｾﾂ	低速電子線回折	名詞
ﾃｲｿｸﾁｭｳｾｲｼ	低速中性子	名詞
ﾃｲｼｮｸﾊﾝﾉｳ	呈色反応	名詞
ﾃｲｼｭｳﾊﾍﾝｾｲｷ	低周波変成器	名詞
ﾃｲﾁｾｲｷﾞｮ	定値制御	名詞
ﾃｲﾁｮｳﾊ	低調波	名詞
ﾃｲﾖｳﾋﾈﾂ	定容比熱	名詞
ﾃｲﾖｳﾓﾙﾋﾈﾂ	定容モル比熱	名詞
ﾃｲｻﾞｲﾊ	定在波	名詞
ﾃｲｻﾞｲﾊﾋ	定在波比	名詞
ﾃｲｻﾞｲﾊﾚｰｻﾞｰ	定在波レーザー	名詞
ﾃｲｻﾞﾂｵﾝｿﾞｳﾌｸｷ	低雑音増幅器	名詞
ﾃｲｼﾞｹﾞﾝｹｯｼｮｳ	低次元結晶	名詞
ﾃｲｼﾞｮｳﾃﾞﾝﾘｭｳ	定常電流	名詞
ﾃｲｼﾞｮｳﾊ	定常波	名詞
ﾃｲｼﾞｮｳｶﾃｲ	定常過程	名詞
ﾃｲｼﾞｮｳﾘｭｳ	定常流	名詞
ﾃｲｼﾞｮｳｳﾁｭｳ	定常宇宙	名詞
ﾃｲｼﾞｮｳｼﾞﾏ	定常じま	名詞
ﾃｲｼﾞｮｳｼﾞｮｳﾀｲ	定常状態	名詞
ﾃｷｺﾞｳｼﾞｮｳｹﾝ	適合条件	名詞
ﾃｷｵｳｹｲｽｳ	適応係数	名詞
ﾃｷｵｳｾｲｷﾞｮ	適応制御	名詞
ﾃｷｽｳｹｲ	滴数計	名詞
ﾃｷﾃｲ	滴定	名詞
ﾃﾑｷﾝﾉｼｷ	テムキンの式	名詞
ﾃﾝﾃﾞﾝｶ	点電荷	名詞
ﾃﾝｹﾞﾝ	点源	名詞
ﾃﾝｸﾞﾝ	点群	名詞
ﾃﾝｲﾐﾂﾄﾞ	転位密度	名詞
ﾃﾝｲﾓｳ	転位網	名詞
ﾃﾝｲﾈﾂ	転移熱	名詞
ﾃﾝｲﾉｿﾞｳｼｮｸ	転位の増殖	名詞
ﾃﾝｲｵﾝﾄﾞ	転移温度	名詞
ﾃﾝｲﾙｰﾌﾟ	転位ループ	名詞
ﾃﾝｲｾﾝ	転位線	名詞
ﾃﾝｲｼﾝ	転位芯	名詞
ﾃﾝｲｿｸﾄﾞ	転位速度	名詞
ﾃﾝｲｿｳｷｮｸｼ	転位双極子	名詞
ﾃﾝｲﾃﾝ	転移点	名詞
ﾃﾝｶﾝﾘﾂ	転換率	名詞
ﾃﾝｶﾝﾛ	転換炉	名詞
ﾃﾝｹｯｶﾝ	点欠陥	名詞
ﾃﾝｺﾃﾞﾝｱﾂ	点弧電圧	名詞
ﾃﾝｺｳｹﾞﾝ	点光源	名詞
ﾃﾝﾓﾝﾀﾝｲ	天文単位	名詞
ﾃﾝﾓﾝﾃｲｽｳ	天文定数	名詞
ﾃﾝﾓﾝｼﾞ	天文時	名詞
ﾃﾝﾈﾝﾎｳｼｬｾﾝｶｸｼｭ	天然放射線核種	名詞
ﾃﾝﾈﾝｳﾗﾝ	天然ウラン	名詞
ﾃﾝｵﾝｹﾞﾝ	点音源	名詞
ﾃﾝﾌﾟﾙﾉｶｶｲ	テンプルの下界	名詞
ﾃﾝｾﾝｹﾞﾝ	点線源	名詞
ﾃﾝｾｯｼｮｸﾀﾞｲｵｰﾄﾞ	点接触ダイオード	名詞
ﾃﾝｾｯｼｮｸﾄﾗﾝｼﾞｽﾀｰ	点接触トランジスター	名詞
ﾃﾝｿﾙ	テンソル	名詞
ﾃﾝｿﾙｴﾝｻﾞﾝｼ	テンソル演算子	名詞
ﾃﾝｿﾙﾘｮｸ	テンソル力	名詞
ﾃﾝｿﾙｾｷ	テンソル積	名詞
ﾃﾝｿﾙｼｮｳﾉﾎｳｿｸ	テンソル商の法則	名詞
ﾃﾝｿﾙﾁｭｳｶﾝｼ	テンソル中間子	名詞
ﾃﾝﾀｲﾌﾞﾂﾘｶﾞｸ	天体物理学	名詞
ﾃﾝﾀｲﾌﾞﾝｺｳｶﾞｸ	天体分光学	名詞
ﾃﾝﾀｲｶｸﾌﾞﾂﾘｶﾞｸ	天体核物理学	名詞
ﾃﾝﾀｲﾌﾟﾗｽﾞﾏ	天体プラズマ	名詞
ﾃﾝﾀｲﾘｷｶﾞｸ	天体力学	名詞
ﾃﾝﾄｳｵﾝﾄﾞｹｲ	転倒温度計	名詞
ﾃﾝｿﾞｳ	点像	名詞
ﾃﾌﾟﾗｰﾎﾟﾝﾌﾟ	テプラーポンプ	名詞
ﾃﾗｰﾘｰﾌﾟｻｲﾓﾝﾉﾃｲﾘ	テラー・リープ・サイモンの定理	名詞
ﾃｰﾙﾊﾞﾝﾄﾞ	テールバンド	名詞
ﾃｻｸﾞﾘﾎｳ	手さぐり法	名詞
ﾃｽﾗ	テスラ	名詞
ﾃﾂｺﾝｽﾀﾝﾀﾝﾈﾂﾃﾞﾝﾂｲ	鉄-コンスタンタン熱電対	名詞
ﾃﾂｿﾝ	鉄損	名詞
ﾃﾂｿﾞｸｹﾞﾝｿ	鉄族元素	名詞
ﾃｨｱﾘﾝｸﾞﾌｱﾝﾃｲｾｲ	ティアリング不安定性	名詞
ﾁﾃﾞﾝﾘｭｳ	地電流	名詞
ﾁｴﾝﾄﾞｳｼﾞｹｲｽｳ	遅延同時計数	名詞
ﾁｴﾝｸﾞﾘｰﾝｶﾝｽｳ	遅延グリーン関数	名詞
ﾁｴﾝｶｲﾛ	遅延回路	名詞
ﾁｴﾝｹｲｺｳ	遅延蛍光	名詞
ﾁｴﾝﾎﾟﾃﾝｼｬﾙ	遅延ポテンシャル	名詞
ﾁｴﾝｾﾝ	遅延線	名詞
ﾁｴﾝｾﾝｷｵｸｿｳﾁ	遅延線記憶装置	名詞
ﾁｴﾝｿｳｲﾝ	遅延掃引	名詞
ﾁｴﾝｽﾍﾟｸﾄﾙ	遅延スペクトル	名詞
ﾁｴﾝｼﾞｶﾝ	遅延時間	名詞
ﾁﾊﾂﾁｭｳｾｲｼ	遅発中性子	名詞
ﾁﾊﾂﾁｭｳｾｲｼｾﾝｺｳｶｸ	遅発中性子先行核	名詞
ﾁｲｻﾅﾎﾟｰﾗﾛﾝ	小さなポーラロン	名詞
ﾁｶﾝﾀﾞﾂﾘ	置換脱離	名詞
ﾁｶﾝｶﾞﾀｺﾖｳﾀｲ	置換型固溶体	名詞
ﾁｶﾝｸﾞﾝ	置換群	名詞
ﾁｶﾝﾎｳ	置換法	名詞
ﾁｶﾝｶﾝﾄﾞｹｲｽｳ	置換感度係数	名詞
ﾁｶﾗﾉﾊﾞ	力の場	名詞
ﾁｶﾗﾉﾌﾞﾝｶｲ	力の分解	名詞
ﾁｶﾗﾉｺﾞｳｾｲ	力の合成	名詞
ﾁｶﾗﾉﾍｲｺｳｼﾍﾝｹｲ	力の平行四辺形	名詞
ﾁｶﾗﾉﾓｰﾒﾝﾄ	力のモーメント	名詞
ﾁｶﾗﾉｻﾝｶｸｹｲ	力の三角形	名詞
ﾁｶﾗﾉｾｲﾌﾞﾝ	力の成分	名詞
ﾁｶﾗﾉﾀｶｸｹｲ	力の多角形	名詞
ﾁｶﾗﾉﾃｲｽｳ	力の定数	名詞
ﾁｶﾗﾉﾂﾘｱｲ	力の釣合い	名詞
ﾁｺﾊﾞﾆｰﾁｪﾝﾊﾞｰ	チコバニーチェンバー	名詞
ﾁｺｳﾌｳ	地衡風	名詞
ﾁｺｳﾘｭｳ	地衡流	名詞
ﾁｸｾｷﾘﾝｸﾞ	蓄積リング	名詞
ﾁｸｾｷｿｳ	蓄積層	名詞
ﾁｸｼﾞｷﾝｼﾞﾎｳ	逐次近似法	名詞
ﾁｸｼﾞｿｳﾃﾝｲ	逐次相転移	名詞
ﾁｷｭｳﾌﾞﾂﾘｶﾞｸ	地球物理学	名詞
ﾁｷｭｳﾀﾞｴﾝﾀｲ	地球楕円体	名詞
ﾁｷｭｳﾀﾞｴﾝﾀｲ	地球だ円体	名詞
ﾁｷｭｳﾈﾝﾀﾞｲｶﾞｸ	地球年代学	名詞
ﾁｷｭｳﾀｲｷ	地球大気	名詞
ﾁｷｭｳｼﾞｷｶﾞｸ	地球磁気学	名詞
ﾁﾝﾀﾞﾙｹﾞﾝｼｮｳ	チンダル現象	名詞
ﾁﾝｺｳﾍｲｺｳ	沈降平衡	名詞
ﾁﾝｺｳｹｲｽｳ	沈降係数	名詞
ﾁｼｾﾝﾘｮｳ	致死線量	名詞
ﾁｼｾﾝﾘｮｳｼｮｳｼｬ	致死線量照射	名詞
ﾁｼﾂﾍﾝﾈﾝ	地質編年	名詞
ﾁｼﾂｵﾝﾄﾞｹｲ	地質温度計	名詞
ﾁｯｿﾚｰｻﾞｰ	窒素レーザー	名詞
ﾁﾂｼﾞｮﾄﾞ	秩序度	名詞
ﾁﾂｼﾞｮｺｳｿﾞｳ	秩序構造	名詞
ﾁﾂｼﾞｮﾑﾁﾂｼﾞｮｶﾞﾀ	秩序-無秩序型	連体詞
ﾁﾂｼﾞｮﾑﾁﾂｼﾞｮｺｳｿﾞｳ	秩序・無秩序構造	名詞
ﾁﾂｼﾞｮﾑﾁﾂｼﾞｮﾃﾝｲ	秩序-無秩序転移	名詞
ﾁﾂｼﾞｮﾊﾟﾗﾒｰﾀｰ	秩序パラメーター	名詞
ﾁﾂｼﾞｮｼﾞｮｳﾀｲ	秩序状態	名詞
ﾁﾁｭｳｵﾝﾄﾞｹｲ	地中温度計	名詞
ﾁﾕｷｮﾘ	治癒距離	名詞
ﾁｼﾞｷｲﾄﾞ	地磁気緯度	名詞
ﾁｼﾞｷﾉﾌｯｶｸ	地磁気の伏角	名詞
ﾁｼﾞｷﾉｻﾝﾖｳｿ	地磁気の三要素	名詞
ﾁｼﾞｷｻﾞﾋｮｳ	地磁気座標	名詞
ﾄｳｱﾂﾍﾝｶ	等圧変化	名詞
ﾄｳｱﾂｾﾝ	等圧線	名詞
ﾄｱﾂｾﾝ	等圧線	名詞
ﾄｳﾌﾞﾊ	頭部波	名詞
ﾄｳﾌﾞﾝﾒﾓﾘ	等分目盛	名詞
ﾄｳﾌﾞﾝﾊﾟｲｿｸ	等分配則	名詞
ﾄﾀﾞｺｳｼ	戸田格子	名詞
ﾄｳﾃﾞﾝｲﾒﾝ	等電位面	名詞
ﾄｳﾃﾞﾝｲｾﾝ	等電位線	名詞
ﾄｳﾃﾞﾝｼｽｳｼｰｹﾝｽ	等電子数シーケンス	名詞
ﾄｳﾃﾞﾝﾃﾝ	等電点	名詞
ﾄｳｴﾝﾄﾛﾋﾟｰｶﾃｲ	等エントロピー過程	名詞
ﾄｸﾞﾁｼﾞｮｳﾀｲ	戸口状態	名詞
ﾄｳﾎｳｾｲﾐﾀﾞﾚ	等方性乱れ	名詞
ﾄｳﾎｳｾｲ	等方性	連体詞
ﾄｳｲﾂﾊﾞﾘﾛﾝ	統一場理論	名詞
ﾄｳｲﾂｹﾞﾝｼｼﾂﾘｮｳﾀﾝｲ	統一原子質量単位	名詞
ﾄｳｲﾂｹﾞｰｼﾞﾘﾛﾝ	統一ゲージ理論	名詞
ﾄｳｶﾃﾞﾝｼｹﾝﾋﾞｷｮｳ	透過電子顕微鏡	名詞
ﾄｳｶﾃﾞﾝｼｾﾝｶｲｾﾂ	透過電子線回折	名詞
ﾄｳｶｴﾝｻﾞﾝｼ	等価演算子	名詞
ﾄｳｶｶﾞﾀ	透過型	連体詞
ﾄｳｶｶﾞﾀｶｲｾﾂｺｳｼ	透過型回折格子	名詞
ﾄｳｶｹﾞﾝﾘ	等価原理	名詞
ﾄｳｶﾊ	透過波	名詞
ﾄｳｶﾊﾊﾞ	等価幅	名詞
ﾄｳｶｶｲﾛ	等価回路	名詞
ﾄｳｶｹｲｽｳ	透過係数	名詞
ﾄｳｶｷﾄﾞｳ	等価軌道	名詞
ﾄｳｶｷﾄﾞｳｶﾝｽｳ	等価軌道関数	名詞
ﾄｳｶｸﾌﾞﾝｼ	等核分子	名詞
ﾄｳｶｸｼｬｿﾞｳ	等角写像	名詞
ﾄｳｶｷｮｳﾒｲ	透過共鳴	名詞
ﾄｶﾏｸ	トカマク	名詞
ﾄｳｶﾉｳ	透過能	名詞
ﾄｳｶﾘﾂ	透過率	名詞
ﾄｳｶｿｸﾄﾞ	等加速度	名詞
ﾁｮｸｾﾝｳﾝﾄﾞｳ	直線運動	名詞
ﾄｳｶｿｸﾄﾞｳﾝﾄﾞｳ	等加速度運動	名詞
ﾄｳｶｿﾝ	透過損	名詞
ﾄｳｶｿﾝｼﾂ	透過損失	名詞
ﾄｳｹｲｴﾝｻﾞﾝｼ	統計演算子	名詞
ﾄｳｹｲｺﾞｻ	統計誤差	名詞
ﾄｳｹｲｲﾝｼ	統計因子	名詞
ﾄｳｹｲｶｸｶﾝｼｮｳ	等傾角干渉	名詞
ﾄｳｹｲｶｸｶﾝｼｮｳｼﾞﾏ	等傾角干渉じま	名詞
ﾄｳｹｲｺｳｶﾞｸ	統計光学	名詞
ﾄｳｹｲﾏﾄﾘｯｸｽ	統計マトリックス	名詞
ﾄｹｲﾏﾜﾘ	時計回り	名詞
ﾄｳｹｲﾈﾂﾘｷｶﾞｸ	統計熱力学	名詞
ﾄｹｲﾉﾊﾟﾗﾄﾞｯｸｽ	時計のパラドックス	名詞
ﾄｳｹｲﾘｷｶﾞｸ	統計力学	名詞
ﾄｳｹｲﾘﾛﾝ	統計理論	名詞
ﾄｳｹｲﾃｷﾍｲｷﾝ	統計的平均	名詞
ﾄｳｹｲﾃｷﾍｲｺｳ	統計的平衡	名詞
ﾄｳｹｲﾃｷｵﾓﾐ	統計的重み	名詞
ﾄｳｹｲﾃｷｽｲｿｸ	統計的推測	名詞
ﾄｳｹｲﾃｷｽｲﾃｲ	統計的推定	名詞
ﾄｳｹｲﾃｷｼｭｳﾀﾞﾝ	統計的集団	名詞
ﾄｳｹﾂｻﾚﾀｼﾞﾊﾞ	凍結された磁場	名詞
ﾄｳｹﾂｻﾞｲ	凍結剤	名詞
ﾄｳｹﾂｼﾞｿｸ	凍結磁束	名詞
ﾄｳｺｳｶﾝｼｮｳ	等厚干渉	名詞
ﾄｳｺｳｶﾝｼｮｳｼﾞﾏ	等厚干渉じま	名詞
ﾄｸｲｾﾂﾄﾞｳ	特異摂動	名詞
ﾄｸｾｲｴﾈﾙｷﾞｰ	特性エネルギー	名詞
ﾄｸｲﾃﾝ	特異点	名詞
ﾄｸｾｲｲﾝﾋﾟｰﾀﾞﾝｽ	特性インピーダンス	名詞
ﾄｸｾｲｶﾝｽｳ	特性関数	名詞
ﾄｸｾｲｷｮｸｾﾝ	特性曲線	名詞
ﾄｸｾｲｵﾝﾄﾞ	特性温度	名詞
ﾄｸｾｲXｾﾝ	特性X線	名詞
ﾄｸｼｭｶｲ	特殊解	名詞
ﾄｸｼｭｿｳﾀｲﾛﾝ	特殊相対論	名詞
ﾄｸｼｭｿｳﾀｲｾｲﾘﾛﾝ	特殊相対性理論	名詞
ﾄｳｷｮｸｹﾂｺﾞｳ	等極結合	名詞
ﾄｰﾏｽ	トーマス	人名
ﾄｰﾏｽ	Thomas	人名
ﾄｰﾏｽﾌｪﾙﾐﾓｹｲ	トーマス・フェルミ模型	名詞
ﾄｰﾏｽﾌｪﾙﾐｼｬﾍｲ	トーマス・フェルミ遮蔽	名詞
ﾄｰﾏｽｲﾝｼ	トーマス因子	名詞
ﾄｰﾏｽｺｳ	トーマス項	名詞
ﾄｰﾏｽﾗｲﾋｪｸｰﾝﾉﾜｿｸ	トーマス・ライヒェ・クーンの和則	名詞
ﾄｰﾏｽｻｲｸﾛﾄﾛﾝ	トーマスサイクロトロン	名詞
ﾄｰﾏｽｻｲｻ	トーマス歳差	名詞
ﾄﾐﾏﾂｻﾄｳｶｲ	富松・佐藤解	名詞
ﾄﾓﾅｶﾞﾗｯﾃｨﾝｼﾞｬｰ	朝永・ラッティンジャー	人名
ﾄﾑｿﾝ	Thomson	人名
ﾄﾑｿﾝﾉｹﾞﾝﾘ	トムソンの原理	名詞
ﾄﾑｿﾝﾉﾎｳｿｸ	トムソンの法則	名詞
ﾄﾑｿﾝｻﾝﾗﾝ	トムソン散乱	名詞
ﾄﾑｽﾞｺｳｶ	トムズ効果	名詞
ﾄｳﾈﾂﾎﾟﾃﾝｼｬﾙ	透熱ポテンシャル	名詞
ﾄﾝﾈﾙﾀﾞｲｵｰﾄﾞ	トンネルダイオード	名詞
ﾄﾝﾈﾙｺｳｶ	トンネル効果	名詞
ﾄﾝﾈﾙｾﾂｺﾞｳ	トンネル接合	名詞
ﾄﾝﾈﾙｽﾍﾟｸﾄﾛｽｺﾋﾟｰ	トンネルスペクトロスコピー	名詞
ﾄｳｵﾝｱｯｼｭｸﾘﾂ	等温圧縮率	名詞
ﾄｳｵﾝﾍﾝｶ	等温変化	名詞
ﾄｳｵﾝｾﾝ	等温線	名詞
ﾄｳｵﾝｼﾞｶﾘﾂ	等温磁化率	名詞
ﾄﾎﾟﾛｼﾞｰﾃｷﾘｮｳｼｽｳ	トポロジー的量子数	名詞
ﾄｳﾎﾟﾃﾝｼｬﾙﾒﾝ	等ポテンシャル面	名詞
ﾄﾗｲﾎﾞﾛｼﾞｰ	トライボロジー	名詞
ﾄﾗｯｸｾﾝｼﾃｨﾌﾞ	トラックセンシティブ	連体詞
ﾄﾗｯｸﾁｪﾝﾊﾞｰ	トラックチェンバー	名詞
ﾄﾗﾝｼｯﾄ	トランシット	名詞
ﾄﾗﾝｽﾃﾞｭｰｻｰ	トランスデューサー	名詞
ﾄﾗﾝｽｷｰﾉﾎｳﾎｳ	トランスキーの方法	名詞
ﾄﾗﾝｼﾞｽﾀｰ	トランジスター	名詞
ﾄﾗﾝｼﾞｼｮﾝｴﾈﾙｷﾞｰ	トランジションエネルギー	名詞
ﾄﾚｰｻｰ	トレーサー	名詞
ﾄﾚｰｽ	トレース	名詞
ﾄﾘｶﾞｰﾎｳﾃﾞﾝ	トリガー放電	名詞
ﾄﾘｶﾞｰｶｲﾛ	トリガー回路	名詞
ﾄﾘｰｸﾞﾗﾌ	トリーグラフ	名詞
ﾄﾘｰｲﾝｸﾞｹﾞﾝｼｮｳ	トリーイング現象	名詞
ﾄﾘﾄﾝ	トリトン	名詞
ﾄｳﾘﾂﾌﾘｺ	倒立振り子	名詞
ﾄﾘﾁｪﾘﾉｼﾝｸｳ	トリチェリの真空	名詞
ﾄﾘｳﾑｹｲﾚﾂ	トリウム系列	人名
ﾄﾛｲﾀﾞﾙｺｲﾙ	トロイダルコイル	名詞
ﾄﾛｲﾀﾞﾙｼﾞﾊﾞ	トロイダル磁場	名詞
ﾄﾛｺｲﾄﾞｶﾞﾀ	トロコイド型	連体詞
ﾄﾛｺｲﾄﾞﾊ	トロコイド波	名詞
ﾄﾙ	トル	名詞
ﾄﾙｸｹｲ	トルク計	名詞
ﾄﾙｻﾄﾛﾝ	トルサトロン	名詞
ﾄｳﾘｮｳ	当量	名詞
ﾄｳｻﾝﾉｳ	逃散能	名詞
ﾄｳｾｷﾍﾝｶ	等積変化	名詞
ﾄｳｿｸｴﾝｳﾝﾄﾞｳ	等速円運動	名詞
ﾄｳｿｸﾁｮｸｾﾝｳﾝﾄﾞｳ	等速直線運動	名詞
ﾄｳﾀﾂｱﾂﾘｮｸ	到達圧力	名詞
ﾄｳﾀﾂｷｮﾘ	到達距離	名詞
ﾄｳﾀﾂｼﾝｸｳﾄﾞ	到達真空度	名詞
ﾄﾂｶﾝｽｳ	凸関数	名詞
ﾄﾂｼｭｳｺﾞｳ	凸集合	名詞
ﾄｳﾁｮｳｴﾝｻﾞﾝｼ	等長演算子	名詞
ﾄﾜｲﾏﾝｸﾞﾘｰﾝ	トワイマン・グリーン	人名
ﾄｼﾞｺﾒ	閉込め	名詞
ﾄｼﾞｺﾒｼﾞﾊﾞ	閉込め磁場	名詞
ﾄｼﾞｺﾒｼﾞｶﾝ	閉込め時間	名詞
ﾄｳｼﾞﾘﾂ	透磁率	名詞
ﾄｳｼﾞｾｲ	等時性	名詞
ﾄｼﾞﾀｹｲ	閉じた系	名詞
ﾄｼﾞﾀﾙｰﾌﾟ	閉じたループ	名詞
ﾄｳｼﾞｭｳﾘﾂﾉｹﾞﾝﾘ	等重率の原理	名詞
ﾂﾎﾞｶﾞﾀｼﾞｼﾝ	つぼ型磁心	名詞
ﾂｲｶｲﾃﾝ	対回転	名詞
ﾂｲｶﾈﾂ	追加熱	名詞
ﾂｲｹﾂｺﾞｳ	対結合	名詞
ﾂｲﾎﾟﾃﾝｼｬﾙ	対ポテンシャル	名詞
ﾂｲｾｲｾｲ	対生成	名詞
ﾂｲｼﾝﾄﾞｳ	対振動	名詞
ﾂｲｿｳｺﾞｻﾖｳ	対相互作用	名詞
ﾂｲｿｳｶﾝｴﾈｷﾞｰ	対相関エネルギー	名詞
ﾂｲｿｳｶﾝｶﾝｽｳ	対相関関数	名詞
ﾂｲｿｳｶﾝﾘｮｸ	対相関力	名詞
ﾂｲｼｮｳﾒﾂ	対消滅	名詞
ﾂｲﾁｾｲｷﾞｮ	追値制御	名詞
ﾂｲｼﾞｭｳｾｲｷﾞｮ	追従制御	名詞
ﾂｷﾇｹｼｭｳﾊｽｳ	突き抜け周波数	名詞
ﾂﾒﾀｲﾌﾟﾗｽﾞﾏ	冷たいプラズマ	名詞
ﾂﾘｱｲ	釣合い	名詞
ﾂﾙﾏｷﾊﾞﾈ	つる巻ばね	名詞
ﾂﾖｲｿｳｺﾞｻﾖｳ	強い相互作用	名詞
ﾂｪﾅｰ	ツェナー	人名
ﾂｪﾅｰ	Zener	人名
ﾂｪﾅｰﾀﾞｲｵｰﾄﾞ	ツェナーダイオード	名詞
ﾂｪﾅｰｺｳｶ	ツェナー効果	名詞
ﾂｪﾅｰﾋﾟｰｸ	ツェナーピーク	名詞
ﾂｨｯﾀｰﾍﾞﾍﾞｰｸﾞﾝｸﾞ	ツィッターベベーグング	名詞
ﾁｬｸｼｮｸﾍﾝｺｳ	着色偏光	名詞
ﾁｬｰﾓﾆｳﾑ	チャーモニウム	名詞
ﾁｬｰﾑ	チャーム	名詞
ﾁｬｰﾑｸｫｰｸ	チャームクォーク	名詞
ﾁｬｰﾑﾘｭｳｼ	チャーム粒子	名詞
ﾁｬﾝﾄﾞﾗｾｶｰﾙｹﾞﾝｶｲ	チャンドラセカール限界	名詞
ﾁｬﾈﾘﾝｸﾞ	チャネリング	名詞
ﾁｬﾈﾙ	チャネル	名詞
ﾁｬﾈﾙﾄﾞｽﾍﾟｸﾄﾙ	チャネルドスペクトル	名詞
ﾁｬﾈﾙｹﾂｺﾞｳﾘﾛﾝ	チャネル結合理論	名詞
ﾁｬﾈﾙﾌﾟﾚｰﾄ	チャネルプーレト	名詞
ﾁｬﾄｯｸｱﾂﾘｮｸｹｲ	チャトック圧力計	名詞
ﾁｪﾋﾞｼｪﾌﾀｺｳｼｷ	チェビシェフ多項式	名詞
ﾁｪﾚﾝｺﾌ	チェレンコフ	人名
ﾁｪﾚﾝｺﾌ	Cherenkov	人名
ﾁｪﾚﾝｺﾌﾎｳｼｬ	チェレンコフ放射	名詞
ﾁｪﾚﾝｺﾌｶｳﾝﾀｰ	チェレンコフカウンター	名詞
ﾁｪﾚﾝｺﾌｺｳ	チェレンコフ光	名詞
ﾁｮｳﾋﾞｻｲﾌﾞﾝﾚﾂ	超微細分裂	名詞
ﾁｮｳﾋﾞｻｲｺｳｿﾞｳ	超微細構造	名詞
ﾁｮｳﾋﾞｻｲｿｳｺﾞｻﾖｳ	超微細相互作用	名詞
ﾁｮｳﾀﾞｲｷﾎﾞ	超大規模	連体詞
ﾁｮｳﾀﾞﾝﾈﾂ	超断熱	名詞
ﾁｮｳﾃﾞﾝﾄﾞｳｹﾞﾝｼｮｳ	超伝導現象	名詞
ﾁｮｳﾃﾞﾝﾄﾞｳﾊｸﾏｸ	超伝導薄膜	名詞
ﾁｮｳﾃﾞﾝﾄﾞｳｸｳﾄﾞｳ	超伝導空洞	名詞
ﾘｮｳｼｶﾝｼｮｳｹｲ	量子干渉計	名詞
ﾁｮｳﾃﾞﾝﾄﾞｳｾﾝｻﾞｲ	超伝導線材	名詞
ﾁｮｳﾃﾞﾝﾄﾞｳｿﾚﾉｲﾄﾞ	超伝導ソレノイド	名詞
ﾁｮｳﾃﾞﾝﾄﾞｳﾀｲ	超伝導体	名詞
ﾁｮｳﾃﾞﾝﾄﾞｳｼﾞｼｬｸ	超電導磁石	名詞
ﾁｮｳﾃﾞﾝﾄﾞｳｼﾞｮｳﾀｲ	超伝導状態	名詞
ﾁｮｳﾃﾞﾝｶ	超電荷	名詞
ﾁｮｳｴﾝｼﾝﾎｳ	超遠心法	名詞
ﾁｮｳｹﾞﾝﾘﾛﾝ	超弦理論	名詞
ﾁｮｳｷﾞﾝｶﾞﾀﾞﾝ	超銀河団	名詞
ﾁｮｳﾊﾝｲｷｿｸﾄﾞ	長範囲規則度	名詞
ﾁｮｳﾊﾝｹｲ	長半径	名詞
ﾁｮｳﾎｳｼｬ	超放射	名詞
ﾁｮｳｲｵﾝﾕｳﾃﾞﾝﾀｲ	超イオン誘電体	名詞
ﾁｮｳｶｲ	潮解	名詞
ﾁｮｳｶｲﾀﾞﾝｾﾂｺﾞｳ	超階段接合	名詞
ﾁｮｳｶｲｿﾞｳ	超解像	名詞
ﾁｮｳｶﾝｽｳ	超関数	名詞
ﾁｮｳｹｲｺｳ	超蛍光	名詞
ﾁｮｳｷｶｶﾝｽｳ	超幾何関数	名詞
ﾁｮｯｹﾂｿﾞｳﾌｸｷ	直結増幅器	名詞
ﾁｮｯｺｳﾃﾞﾝｼﾞﾊﾞ	直交電磁場	連体詞
ﾁｮｯｺｳｸﾞﾝ	直交群	名詞
ﾁｮｯｺｳｶﾝｽｳ	直交関数	名詞
ﾁｮｯｺｳｹｲ	直交系	名詞
ﾁｮｯｺｳﾆｺﾙ	直交ニコル	名詞
ﾁｮｯｺｳｻﾞﾋｮｳ	直交座標	名詞
ﾁｮｯｺｳｼｭｳﾀﾞﾝ	直交集団	名詞
ﾁｮｳｺｳｶﾝｿｳｺﾞｻﾖｳ	超交換相互作用	名詞
ﾁｮｳｺｳﾐﾂﾄﾞｾｲ	超高密度星	名詞
ﾁｮｳｺｳｼ	超格子	名詞
ﾁｮｳｺｳｼﾊﾝｼｬ	超格子反射	名詞
ﾁｮｳｺｳｼｺｳｿﾞｳ	超格子構造	名詞
ﾁｮｳｺｳｼﾝｸｳ	超高真空	名詞
ﾁｮｳｺｳｼﾝｸｳｹｲ	超高真空計	名詞
ﾁｮｳｺｳｼﾃﾝｲ	超格子転位	名詞
ﾁｮｳｺｳｿｳﾀｲｷ	超高層大気	連体詞
ﾁｮｳﾍﾝﾎｳ	超偏法	名詞
ﾁｮｰｸｺｲﾙ	チョークコイル	名詞
ﾁｮｸﾗﾙｽｷｰﾎｳ	チョクラルスキー法	名詞
ﾁｮｸﾚﾂｷｮｳｼﾝ	直列共振	名詞
ﾁｮｸﾚﾂｾﾂｿﾞｸ	直列接続	名詞
ﾁｮｸﾘｭｳﾌﾞﾝｻｲｾｲ	直流分再生	名詞
ﾁｮｸﾘｭｳﾌﾞﾘｯｼﾞ	直流ブリッジ	名詞
ﾁｮｸﾘｭｳﾃﾞﾝﾄﾞｳｷ	直流電動機	名詞
ﾁｮｸﾘｭｳﾃﾞﾝｲｻｹｲ	直流電位差計	名詞
ﾁｮｸﾘｭｳﾃﾞﾝﾘｭｳｹｲ	直流電流計	名詞
ﾁｮｸﾘｭｳﾊﾂﾃﾞﾝｷ	直流発電機	名詞
ﾁｮｸﾘｭｳﾍﾝｱﾂｷ	直流変圧器	名詞
ﾁｮｸﾘｭｳｶｲﾛ	直流回路	名詞
ﾁｮｸﾘｭｳｺﾛﾅ	直流コロナ	名詞
ﾁｮｸﾘｭｳｿﾞｳﾌｸｷ	直流増幅器	名詞
ﾁｮｸﾘｭｳｼﾞｮｾﾌｿﾝｺｳｶ	直流ジョセフソン効果	名詞
ﾁｮｸｻ	直鎖	名詞
ﾁｮｸｾｷ	直積	名詞
ﾁｮｸｾﾝﾌﾞﾝｼ	直線分子	名詞
ﾁｮｸｾﾝﾃﾞﾝﾘｭｳ	直線電流	名詞
ﾁｮｸｾﾝﾍﾝｺｳ	直線偏光	名詞
ﾁｮｸｾﾝﾍﾝﾊﾟ	直線偏波	名詞
ﾁｮｸｾﾝｶｿｸｷ	直線加速器	名詞
ﾁｮｸｾﾝｹﾝﾊﾟ	直線検波	名詞
ﾁｮｸｾﾝﾆｼｮｸｾｲ	直線二色性	名詞
ﾁｮｸｾﾝﾋﾟﾝﾁ	直線ピンチ	名詞
ﾁｮｸｾﾂｷﾞｬｯﾌﾟ	直接ギャップ	連体詞
ﾁｮｸｾﾂﾊﾝﾉｳ	直接反応	名詞
ﾁｮｸｾﾂﾎｳ	直接法	名詞
ﾁｮｸｾﾂｺｳｶﾝｿｳｺﾞｻﾖｳ	直接交換相互作用	名詞
ﾁｮｸｾﾂｾｷﾌﾞﾝ	直接積分	名詞
ﾁｮｸｾﾂｾﾝｲ	直接遷移	名詞
ﾁｮｸｾﾂｿｳｺﾞｻﾖｳ	直接相互作用	名詞
ﾁｮｸｾﾂｿｳｶﾝｶﾝｽｳ	直接相関関数	名詞
ﾁｮｸｾﾂｿｸﾃｲ	直接測定	名詞
ﾁｮｸｼﾌﾞﾝｺｳｷ	直視分光器	名詞
ﾁｮｸｼﾌﾟﾘｽﾞﾑ	直視プリズム	名詞
ﾁｮｸﾜ	直和	名詞
ﾁｮｳｷｮﾘｷｿｸﾄﾞ	長距離規則度	名詞
ﾁｮｳｷｮｾｲ	超巨星	名詞
ﾁｮｳｷｮｳﾔｸ	超共役	名詞
ﾁｮｳｷｮﾖｳｾﾝｲ	超許容遷移	名詞
ﾁｮｳｵﾝﾊﾟｹﾞﾝｽｲ	超音波減衰	名詞
ﾁｮｳｵﾝﾊﾟﾋｶﾘｶｲｾﾂ	超音波光回折	名詞
ﾁｮｳｵﾝﾊﾟﾎﾛｸﾞﾗﾌｨｰ	超音波ホログラフィー	名詞
ﾁｮｳｵﾝﾊﾟｶｺｳ	超音波加工	名詞
ﾁｮｳｵﾝﾊﾟｶﾝｼｮｳｹｲ	超音波干渉計	名詞
ﾁｮｳｵﾝﾊﾟｶﾝﾜ	超音波緩和	名詞
ﾁｮｳｵﾝﾊﾟｹﾝﾋﾞｷｮｳ	超音波顕微鏡	名詞
ﾁｮｳｵﾝﾊﾟｷｭｳｼｭｳ	超音波吸収	名詞
ﾁｮｳｵﾝﾊﾟｾﾝｼﾞｮｳ	超音波洗浄	名詞
ﾁｮｳｵﾝﾊﾟｼﾝﾀﾞﾝ	超音波診断	名詞
ﾁｮｳｵﾝﾊﾟﾀﾝｼｮｳ	超音波探傷	名詞
ﾁｮｳｵﾝﾊﾟﾀﾝｼｮｳﾎｳ	超音波探傷法	名詞
ﾁｮｳｵﾝﾊﾟﾉｽﾞﾙ	超音波ノズル	名詞
ﾁｮｯﾊﾟｰｿﾞｳﾌｸｷ	チョッパー増幅器	名詞
ﾁｮｯﾊﾟｰｶﾞﾀｿﾞｳﾌｸｷ	チョッパー型増幅器	名詞
ﾁｮｳﾚｲｷｼﾞｮｳﾀｲ	超励起状態	名詞
ﾁｮｳﾘﾝｶｲ	超臨界	連体詞
ﾁｮｳﾘｮｸﾊﾞ	張力場	名詞
ﾁｮｳﾘｮｸｹｲ	張力計	名詞
ﾁｮｳﾘｮｸｿｸﾃｲ	聴力測定	名詞
ﾁｮｳﾘｭｳﾄﾞｳ	超流動	名詞
ﾁｮｳﾘｭｳﾄﾞｳﾍﾘｳﾑ	超流動ヘリウム	名詞
ﾁｮｳﾘｭｳﾀｲ	超流体	名詞
ﾁｮｳｾｷﾏｻﾂ	潮汐摩擦	名詞
ﾁｮｳｾﾝﾀｸｿｸ	超選択則	名詞
ﾁｮｳｼﾝｾｲﾊﾞｸﾊﾂ	超新星爆発	名詞
ﾁｮｳｼﾝｾｲｻﾞﾝｶﾞｲ	超新星残がい	名詞
ﾁｮｳｿｾｲ	超塑性	名詞
ﾁｮｳｼｭｳｷﾍﾝｺｳｾｲ	長周期変光星	名詞
ﾁｮｳｼｭｳｷｺｳｿﾞｳ	長周期構造	名詞
ﾁｮｳﾀｲｼｮｳｾｲ	超対称性	名詞
ﾁｮｳﾀｼﾞｶﾝﾘﾛﾝ	超多時間理論	名詞
ﾁｮｳﾀｼﾞｭｳｺｳ	超多重項	名詞
ﾁｮｳﾃｲｵﾝ	超低温	名詞
ﾁｮｳﾃｲｼｭｳﾊﾎｳｼｬ	超低周波放射	名詞
ﾁｮｳﾃｲｼｭｳﾊｵﾝ	超低周波音	名詞
ﾁｮｳﾃﾝｸｯｾﾂﾘｮｸ	頂点屈折力	名詞
ﾁｮｳﾁｮｳｷｾﾝ	超長基線	連体詞
ﾁｮｳｳﾗﾝｹﾞﾝｿ	超ウラン元素	名詞
ﾁｮｳﾜﾌﾞﾝｾｷ	調和分析	名詞
ﾁｮｳﾜｶﾝｽｳ	調和関数	名詞
ﾁｮｳﾜｷﾝｼﾞ	調和近似	名詞
ﾁｮｳﾜﾎﾟﾃﾝｼｬﾙ	調和ポテンシャル	名詞
ﾁｮｳﾜｼﾝﾄﾞｳ	調和振動	名詞
ﾁｮｳﾜｼﾝﾄﾞｳｼ	調和振動子	名詞
ﾁｮｿﾞｳﾀﾞﾝｾｲﾘﾂ	貯蔵弾性率	名詞
ﾁｮｿﾞｳﾘﾝｸﾞ	貯蔵リング	名詞
ﾁｮｳｼﾞｮｳｼﾞｾｲ	超常磁性	名詞
ﾁｮｳｼﾞｭｳｹﾞﾝｿ	超重元素	名詞
ﾁｮｳｼﾞｭｳｶｸ	超重核	名詞
ﾁｮｳｼﾞｭｳﾘｮｸ	超重力	名詞
ﾁｮｳｼﾞｭｳｼﾞｭﾝｹﾞﾝｼ	超重準原子	名詞
ﾁｭｰﾌﾗｳﾁｽﾞ	チュー・フラウチ図	名詞
ﾁｭｳｶﾝﾎﾞｿﾝ	中間ボソン	名詞
ﾁｭｳｶﾝｴﾈﾙｷﾞｰ	中間エネルギー	連体詞
ﾁｭｳｶﾝｹﾂｺﾞｳ	中間結合	名詞
ﾁｭｳｶﾝｷｮｳﾒｲ	中間共鳴	名詞
ﾁｭｳｶﾝｼ	中間子	名詞
ﾁｭｳｶﾝｼｹﾞﾝｼ	中間子原子	名詞
ﾁｭｳｶﾝｼﾎｳｶｲ	中間子崩壊	名詞
ﾁｭｳｶﾝｼﾛﾝ	中間子論	名詞
ﾁｭｳｶﾝｼｭｳﾊｽｳ	中間周波数	名詞
ﾁｭｳｶﾝｼﾞｮｳﾀｲ	中間状態	名詞
ﾁｭｳｸｳﾄﾞｳﾀｲ	中空導体	名詞
ﾁｭｳｸｳｲﾝｷｮｸﾎｳﾃﾞﾝ	中空陰極放電	名詞
ﾁｭｳﾆｭｳｶﾞﾀﾚｰｻﾞｰ	注入型レーザー	名詞
ﾁｭｳﾘﾂﾍｲｺｳ	中立平衡	名詞
ﾁｭｳﾘﾂﾒﾝ	中立面	名詞
ﾁｭｳﾘﾂｼﾞｸ	中立軸	名詞
ﾁｭｰﾛｰﾘﾛﾝ	チュー・ロー理論	名詞
ﾁｭｳｾｲﾋﾞｰﾑ	中性ビーム	名詞
ﾁｭｳｾｲﾋﾞｼ	中性微子	名詞
ﾁｭｳｾｲｲｵﾝｾｲﾃﾝｲ	中性-イオン性転移	名詞
ﾁｭｳｾｲｶﾚﾝﾄ	中性カレント	名詞
ﾁｭｳｾｲﾘｭｳｼ	中性粒子	名詞
ﾆｭｳｼｬｶﾈﾂ	入射加熱	名詞
ﾁｭｳｾｲｼ	中性子	名詞
ﾁｭｳｾｲｼﾌﾞﾝｺｳｷ	中性子分光器	名詞
ﾁｭｳｾｲｼﾃﾞﾝﾊﾟ	中性子伝播	名詞
ﾁｭｳｾｲｼﾃﾞﾝﾊﾟ	中性子伝ぱ	名詞
ﾁｭｳｾｲｼﾌｨﾙﾀｰ	中性子フィルター	名詞
ﾁｭｳｾｲｼｶﾞｲﾄﾞｶﾝ	中性子ガイド管	名詞
ﾁｭｳｾｲｼｹﾞﾝ	中性子源	名詞
ﾁｭｳｾｲｼﾎｶｸ	中性子捕獲	名詞
ﾁｭｳｾｲｼｶｲｾﾂ	中性子回折	名詞
ﾁｭｳｾｲｼｶｲｾﾂｹｲ	中性子回折計	名詞
ﾁｭｳｾｲｼｶｲｾﾂｿｳﾁ	中性子回折装置	名詞
ﾁｭｳｾｲｼｶｼﾞｮｳ	中性子過剰	名詞
ﾁｭｳｾｲｼｹﾝｼｭﾂｷ	中性子検出器	名詞
ﾁｭｳｾｲｼｷｮｳﾒｲ	中性子共鳴	名詞
ﾁｭｳｾｲｼﾓﾉｸﾛﾒｰﾀｰ	中性子モノクロメーター	名詞
ﾁｭｳｾｲｼｵﾝﾄﾞ	中性子温度	名詞
ﾁｭｳｾｲｼｻﾝﾗﾝ	中性子散乱	名詞
ﾁｭｳｾｲｼｾｲ	中性子星	名詞
ﾁｭｾｲｼｾﾝﾘｮｳｿｸﾃｲ	中性子線量測定	名詞
ﾁｭｳｾｲｼｿｸ	中性子束	名詞
ﾁｭｳｾｲｼｾﾝｿｸ	中性子線束	名詞
ﾁｭｳｾｲｼｽﾍﾟｸﾄﾛﾒｰﾀｰ	中性子スペクトルメーター	名詞
ﾁｭｳｾｲｼｽﾋﾟﾝﾌﾘｯﾊﾟｰ	中性子スピンフリッパー	名詞
ﾁｭｳｾｲｼﾀﾝｼｮｸｷ	中性子単色器	名詞
ﾁｭｳｾｲｼﾁｮｯﾊﾟｰ	中性子チョッパー	名詞
ﾁｭｳｾｲｼｿﾞｳﾊﾞｲﾘﾂ	中性子増倍率	名詞
ﾁｭｳｾｲｼﾞｸ	中性軸	名詞
ﾁｭｳｼﾝｸｳ	中真空	名詞
ﾁｭｳｼﾝｷｮｸｹﾞﾝﾃｲﾘ	中心極限定理	名詞
ﾁｭｳｼﾝﾘｮｸ	中心力	名詞
ﾁｭｳｼﾝﾘｮｸﾊﾞ	中心力場	名詞
ﾁｭｳｿｸﾃﾞﾝｼｾﾝｶｲｾﾂ	中速電子線回折	名詞
ﾁｭｳｿｸﾁｭｳｾｲｼﾛ	中速中性子炉	名詞
ﾁｭｳｽｳｼﾝｹｲｹｲ	中枢神経系	名詞
ﾁｭｳｶﾝﾘｭｳ	中間流	名詞
ﾁｭｳｼﾞﾂﾄﾞ	忠実度	名詞
ｳｶﾃｲ	U過程	名詞
ｳﾁｬﾈﾙ	uチャネル	名詞
ｳｼﾞｶﾝｱﾂﾘｮｸｹｲ	U字管圧力計	名詞
ｳﾍﾞﾛｰﾃﾞﾈﾝﾄﾞｹｲ	ウベローデ粘度計	名詞
ｳｯﾄﾞｺﾞｳｷﾝ	ウッド合金	名詞
ｳｴｲｸﾎﾟﾃﾝｼｬﾙ	ウエイクポテンシャル	名詞
ｳｲｽｶｰ	ウイスカー	名詞
ｳｷｼﾞｼｬｸ	浮き磁石	名詞
ｳﾑｸﾗｯﾌﾟｶﾃｲ	ウムクラップ過程	名詞
ｳﾅﾘｼｭｳﾊｽｳ	うなり周波数	名詞
ｳﾝﾄﾞｳﾃﾞﾝｲ	運動電位	名詞
ｳﾝﾄﾞｳｴﾈﾙｷﾞｰ	運動エネルギー	名詞
ｳﾝﾄﾞｳｶﾞｸ	運動学	名詞
ｳﾝﾄﾞｳｶﾞｸﾃｷ	運動学的	名詞
ｳﾝﾄﾞｳｶﾞｸﾃｷｹｲｽｳ	運動学的係数	名詞
ｳﾝﾄﾞｳｶﾞｸﾃｷﾘﾛﾝ	運動学的理論	名詞
ｳﾝﾄﾞｳｺｳｶﾝ	運動交換	名詞
ｳﾝﾄﾞｳﾆﾖﾙｾﾝｴｲｶ	運動による尖鋭化	名詞
ｳﾝﾄﾞｳﾆﾖﾙｾﾝｴｲｶ	運動によるせん鋭化	名詞
ｳﾝﾄﾞｳﾉﾎｳｿｸ	運動の法則	名詞
ｳﾝﾄﾞｳﾉｾｷﾌﾞﾝ	運動の積分	名詞
ｳﾝﾄﾞｳﾉﾃｲｽｳ	運動の定数	名詞
ｳﾝﾄﾞｳﾎﾟﾃﾝｼｬﾙ	運動ポテンシャル	名詞
ｳﾝﾄﾞｳﾛﾝﾃｷﾎｳﾃｲｼｷ	運動論的方程式	名詞
ｳﾝﾄﾞｳﾘｮｳｱｯｼｭｸﾘﾂ	運動量圧縮率	名詞
ｳﾝﾄﾞｳﾘｮｳｱﾂｻ	運動量厚さ	名詞
ｳﾝﾄﾞｳﾘｮｳﾌﾞﾝｾｷﾖｳ	運動量分析用	連体詞
ｳﾝﾄﾞｳﾘｮｳﾌﾞﾝｾｷ	運動量分析	連体詞
ｳﾝﾄﾞｳﾘｮｳﾎｿﾞﾝｿｸ	運動量保存則	名詞
ｳﾝﾄﾞｳﾘｮｳﾋｮｳｼﾞ	運動量表示	名詞
ｳﾝﾄﾞｳﾘｮｳｲﾄﾞｳ	運動量移動	名詞
ｳﾝﾄﾞｳﾘｮｳｲｺｳ	運動量移行	名詞
ｳﾝﾄﾞｳﾘｮｳﾓｰﾒﾝﾄ	運動量モーメント	名詞
ｳﾝﾄﾞｳﾘｮｳﾃｷｵｳｹｲｽｳ	運動量適応係数	名詞
ｳﾝﾄﾞｳﾘｮｳﾕｿｳﾘﾛﾝ	運動量輸送理論	名詞
ｳﾝﾄﾞｳﾘｮｳﾕｿｳｼｷ	運動量輸送式	連体詞
ｳﾝﾄﾞｳｻﾞﾋｮｳｹｲ	運動座標系	名詞
ｳﾝﾊﾟﾝﾃﾞﾝﾘｭｳ	運搬電流	名詞
ｳﾗｺｳｼ	裏格子	名詞
ｳﾗﾝｹｲﾚﾂ	ウラン系列	名詞
ｳﾗﾝﾉｳｼｭｸ	ウラン濃縮	名詞
ｳﾗﾝﾗｼﾞｳﾑｹｲﾚﾂ	ウラン-ラジウム系列	名詞
ｳﾙｳﾋﾞｮｳ	うるう秒	名詞
ｳﾙﾌﾓｹｲ	ウルフ模型	名詞
ｳﾙﾌﾌﾟﾛｯﾄ	ウルフプロット	名詞
ｳﾙﾂｺｳｶﾞﾀｺｳｿﾞｳ	ウルツ鉱型構造	名詞
ｳｽﾆｸﾚﾝｽﾞ	薄肉レンズ	名詞
ｳﾁｷﾘｺﾞｻ	打切誤差	名詞
ｳﾁｭｳﾌﾞﾂﾘｶﾞｸ	宇宙物理学	名詞
ｳﾁｭｳﾃﾞﾝﾊﾟ	宇宙電波	名詞
ｳﾁｭｳﾃﾞﾝﾊﾟｹﾞﾝ	宇宙電波源	名詞
ｳﾁｭｳｹﾞﾝﾘ	宇宙原理	名詞
ｳﾁｭｳｶﾞﾝﾏｾﾝ	宇宙γ線	名詞
ｳﾁｭｳﾊｲｹｲﾎｳｼｬ	宇宙背景放射	名詞
ｳﾁｭｳﾎｳｼｬｾﾝ	宇宙放射線	連体詞
ﾈﾝﾀﾞｲｶﾞｸ	年代学	名詞
ｳﾁｭｳｺｳ	宇宙項	名詞
ｳﾁｭｳｸｳｶﾝﾌﾞﾂﾘｶﾞｸ	宇宙空間物理学	名詞
ｳﾁｭｳﾒｰｻﾞｰ	宇宙メーザー	名詞
ｳﾁｭｳﾉﾈﾝﾚｲ	宇宙の年齢	名詞
ｳﾁｭｳﾆｭｰﾄﾘﾉ	宇宙ニュートリノ	名詞
ｳﾁｭｳﾛﾝ	宇宙論	名詞
ｳﾁｭｳｾﾝ	宇宙線	名詞
ｳﾁｭｳｾﾝﾌﾞﾂﾘｶﾞｸ	宇宙線物理学	名詞
ｳﾁｭｳｾﾝｼｬﾜｰ	宇宙線シャワー	名詞
ｳﾁｭｳｾﾝｼｮｳｼｬﾈﾝﾀﾞｲ	宇宙線照射年代	名詞
ｳﾁｭｳｼﾝｶﾛﾝ	宇宙進化論	名詞
ｳﾁｭｳｿｸﾄﾞ	宇宙速度	名詞
ｳﾁｭｳﾃｲｽｳ	宇宙定数	名詞
ｳﾁｭｳﾄｳｷ	宇宙投棄	名詞
ｳﾁｭｳXｾﾝ	宇宙X線	名詞
ｳﾁｭｳｼﾞ	宇宙時	名詞
ｳﾁｭｳｼﾞﾝ	宇宙塵	名詞
ｳﾜｻﾞﾗﾃﾝﾋﾞﾝ	上皿てんびん	名詞
ｳｽﾞﾃﾞﾝﾘｭｳ	渦電流	名詞
ｳｽﾞﾄﾞ	渦度	名詞
ｳｽﾞﾄﾞﾕｿｳﾘﾛﾝ	渦度輸送理論	名詞
ｳｽﾞｲﾄ	渦糸	名詞
ｳｽﾞｶｸｻﾝﾘﾂ	渦拡散率	名詞
ｳｽﾞｶﾝ	渦管	名詞
ｳｽﾞﾏｷｾｲﾁｮｳ	渦巻成長	名詞
ｳｽﾞﾒﾝ	渦面	名詞
ｳｽﾞﾅｼ	渦なし	連体詞
ｳｽﾞﾅｼｳﾝﾄﾞｳ	渦なし運動	名詞
ｳｽﾞﾈﾝｾｲ	渦粘性	名詞
ｳｽﾞﾉｶﾝ	渦の管	名詞
ｳｽﾞﾉﾚﾂ	渦の列	名詞
ｳｽﾞﾉｿｳ	渦の層	名詞
ｳｽﾞﾉﾂｲ	渦の対	名詞
ｳｽﾞｵﾝ	渦音	名詞
ｳｽﾞﾚﾂ	渦列	名詞
ｳｽﾞｾﾝ	渦線	名詞
ｳｽﾞｿｳ	渦層	名詞
ｳｽﾞﾂｲ	渦対	名詞
ｳｽﾞｳﾝﾄﾞｳ	渦運動	名詞
ｳｽﾞﾜ	渦輪	名詞
ｳｽﾞｼﾞｮｳｷﾞﾝｶﾞ	渦状銀河	名詞
VBﾎｳ	VB法	名詞
VLSｷｺｳ	VLS機構	名詞
Vﾝｾﾝｲ	V-N遷移	名詞
Wﾎﾞｿﾝ	Wボソン	名詞
WKBﾎｳ	WKB法	名詞
WLFｼｷ	WLF式	名詞
ﾜｲｷｮｸ	わい曲	名詞
ﾜｲﾝﾊﾞｰｸﾞｶｸ	ワインバーグ角	名詞
ﾜｲﾝﾊﾞｰｸﾞｻﾗﾑﾓｹｲ	ワインバーグ・サラム模型	名詞
ﾜｲﾙﾎｳﾃｲｼｷ	ワイル方程式	名詞
ﾜｲﾙﾉﾎｳﾃｲｼｷ	ワイルの方程式	名詞
ﾜｲﾙｽﾋﾟﾉﾙ	ワイルスピノル	名詞
ﾜｲｾｲ	矮星	名詞
ﾜｲｾｲ	わい星	名詞
ﾜｲｾﾝﾍﾞﾙｸｶﾒﾗ	ワイセンベルクカメラ	名詞
ﾜｲｽ	ワイス	人名
ﾜｲｽ	Weiss	人名
ﾜｲｽｷﾝｼﾞ	ワイス近似	名詞
ﾜｲｽｺｯﾌﾟﾀﾝｲ	ワイスコップ単位	名詞
ﾜｲｽｵﾝﾄﾞ	ワイス温度	名詞
ﾜｲﾄﾏﾝｶﾝｽｳ	ワイトマン関数	名詞
ﾜｲﾄﾏﾝﾉｺｳﾘｹｲ	ワイトマンの公理系	名詞
ﾜｲﾂｾﾞｯｶｰ	ワイツゼッカー	人名
ｳｨﾘｱﾑｽｷﾝｼﾞ	・ウィリアムス近似	名詞
ﾜｲﾔｰﾁｪﾝﾊﾞｰ	ワイヤーチェンバー	名詞
ﾜｸｾｲﾊﾄﾞｳ	惑星波動	名詞
ﾜｸｾｲｶﾝﾌﾞｯｼﾂ	惑星間物質	名詞
ﾜｸｾｲｶﾝｸｳｶﾝ	惑星間空間	名詞
ﾜｸｾｲｻｲｻ	惑星歳差	名詞
ﾜｸｾｲｼﾞｮｳｾｲｳﾝ	惑星状星雲	名詞
ﾜﾆｴﾚｲｷｼ	ワニエ励起子	名詞
ﾜﾝｷｮｸｹｯｼｮｳﾎｳ	湾曲結晶法	名詞
ﾜﾗｰﾉﾊﾟﾗﾄﾞｯｸｽ	ワラーのパラドックス	名詞
ﾜﾗｰｾｷﾌﾞﾝ	ワラー積分	名詞
ﾜｿｸ	和則	名詞
ﾜｼｭｳﾊﾊｯｾｲ	和周波発生	名詞
ﾜｯﾄ	ワット	名詞
ﾜｯﾄｼﾞ	ワット時	名詞
ｳｪｰﾊﾞ	ウェーバ	名詞
ｳｪｰﾊﾞｰｶﾝｽｳ	ウェーバー関数	名詞
ｳｪｰﾊﾞｰｽｳ	ウェーバー数	名詞
ｳｪｰﾈﾙﾄｴﾝﾄｳ	ウェーネルト円筒	名詞
ｳｪｽﾄﾝﾃﾞﾝﾁ	ウェストン電池	名詞
ｳｪｽﾄﾝｹｲｷ	ウェストン計器	名詞
ｳｨｸﾞﾅｰ	ウィグナー	人名
ｳｨｸﾞﾅｰ	Wigner	人名
ｳｨｸﾞﾅｰﾊﾞｰｸﾞﾏﾝ	ウィグナー・バーグマン	人名
ｳｨｸﾞﾅｰﾌﾞﾝﾌﾟ	ウィグナー分布	名詞
ｳｨｸﾞﾅｰｴｯｶﾙﾄﾉﾃｲﾘ	ウィグナー・エッカルトの定理	名詞
ｳｨｸﾞﾅｰｹｯｼｮｳ	ウィグナー結晶	名詞
ｳｨｸﾞﾅｰﾉｼﾞｶﾝﾊﾝﾃﾝ	ウィグナーの時間反転	名詞
ｳｨｸﾞﾅｰﾘｮｸ	ウィグナー力	名詞
ｳｨｸﾞﾅｰｻﾞｲﾂﾎｳ	ウィグナー・ザイツ法	名詞
ｳｨｸﾞﾅｰｻﾞｲﾂｷｭｳ	ウィグナー・ザイツ球	名詞
ｳｨｸﾞﾗｰ	ウィグラー	名詞
ｳｨｰﾃﾞﾏﾝﾌﾗﾝﾂﾉﾎｳｿｸ	ウィーデマン・フランツの法則	名詞
ｳｨｰﾃﾞﾏﾝｺｳｶ	ウィーデマン効果	名詞
ｳｨｰｸﾎﾞｿﾝ	ウィークボソン	名詞
ｳｨｰﾅｰ	ウィーナー	人名
ｳｨｰﾅｰ	Wiener	人名
ｳｨｰﾅｰﾋﾝﾁﾝﾉｶﾝｹｲ	ウィーナー・ヒンチンの関係	名詞
ｳｨｰﾅｰﾎｯﾌﾟﾎｳ	ウィーナー・ホップ法	名詞
ｳｨｰﾅｰｿｸﾄﾞ	ウィーナー測度	名詞
ｳｨｰﾝ	ウィーン	人名
ｳｨｰﾝ	Wien	人名
ｳｨｰﾝﾌﾞﾘｯｼﾞ	ウィーンブリッジ	名詞
ｳｨｰﾝﾉﾍﾝｲｿｸ	ウィーンの変位則	名詞
ｳｨｰﾝﾉﾎｳｼｬｿｸ	ウィーンの放射則	名詞
ｳｨｰﾝﾉﾎｳｼｬﾎｳｿｸ	ウィーンの放射法則	名詞
ｳｨｯｸｶｲﾃﾝ	ウィック回転	名詞
ｳｨｯｸﾉﾃｲﾘ	ウィックの定理	名詞
ｳｨﾙｿﾝ	ウィルソン	人名
ｳｨﾙｿﾝ	Wilson	人名
ｳｨﾙｿﾝｷﾘﾊﾞｺ	ウィルソン霧箱	名詞
ｳｨﾙｿﾝﾓｹｲ	ウィルソン模型	名詞
ｳｨﾙｿﾝｼｰﾙ	ウィルソンシール	名詞
ｳｨﾙｿﾝﾃﾝｶｲ	ウィルソン展開	名詞
ｳｫｰﾄﾞﾀｶﾊｼﾉｺｳﾄｳｼｷ	ウォード・高橋の恒等式	名詞
ｳｫｰｶｰﾓｰﾄﾞ	ウォーカーモード	名詞
ｳｫﾗｽﾄﾝﾌﾟﾘｽﾞﾑ	ウォラストンプリズム	名詞
ｳｫﾗｽﾄﾝｾﾝ	ウォラストン線	名詞
ｳｫﾙｼｭｽﾞ	ウォルシュ図	名詞
Xｾﾝ	X線	名詞
Xｾﾝﾌﾞﾝｺｳｶﾞｸ	X線分光学	名詞
Xｾﾝﾌｨﾙﾀｰ	X線フィルター	名詞
Xｾﾝﾊｯｾｲｿｳﾁ	X線発生装置	名詞
Xｾﾝｶｲｾﾂ	X線回折	名詞
Xｾﾝｶｲｾﾂｹﾝﾋﾞｷｮｳ	X線回折顕微鏡	名詞
Xｾﾝｶﾝ	X線管	名詞
Xｾﾝｶﾝｼｮｳｹｲ	X線干渉計	名詞
Xｾﾝｹｯｼｮｳｶﾞｸ	X線結晶学	名詞
Xｾﾝｺｳ	X線項	名詞
Xｾﾝｺｳﾃﾞﾝｼﾌﾞﾝｺｳﾎｳ	X線光電子分光法	名詞
Xｾﾝｺｳｶﾞｸ	X線光学	名詞
Xｾﾝｺｳｿﾞｳｶｲｾｷ	X線構造解析	名詞
Xｾﾝｷｭｳｼｭｳﾀﾝ	X線吸収端	名詞
Xｾﾝﾚｰｻﾞｰ	X線レーザー	名詞
Xｾﾝｾｲ	X線星	名詞
Xｾﾝﾀﾝｲ	X線単位	名詞
Xｾﾝﾃﾝﾓﾝｶﾞｸ	X線天文学	名詞
Xｾﾝﾄﾎﾟｸﾞﾗﾌｨｰ	X線トポグラフィー	名詞
Xｾﾝｹﾞﾝｶｲ	X線限界	名詞
Xｾﾝﾙﾐﾈｾﾝｽ	X線ルミネセンス	名詞
ﾔGﾚｰｻﾞｰ	YAGレーザー	名詞
Yｹｯｾﾝ	Y結線	名詞
ﾔｷｲﾚ	焼入れ	名詞
ﾔｷﾅﾏｼ	焼なまし	名詞
ﾔｺﾋﾞﾀﾞｴﾝﾀｲ	ヤコビ楕円体	名詞
ﾔｺﾋﾞﾀﾞｴﾝﾀｲ	ヤコビだ円体	名詞
ﾔｺﾋﾞﾉｺｳﾄｳｼｷ	ヤコビの恒等式	名詞
ﾔﾝﾌｪﾙﾄﾞﾏﾝﾎｳﾃｲｼｷ	ヤン・フェルドマン方程式	名詞
ﾔﾝｸﾞ	ヤング	人名
ﾔﾝｸﾞ	Young	人名
ﾔﾝｸﾞﾋｮｳ	ヤング表	名詞
ﾔﾝｸﾞﾉｼﾞｯｹﾝ	ヤングの実験	名詞
ﾔﾝｸﾞﾘﾂ	ヤング率	名詞
ﾔﾝｸﾞｽﾞ	ヤング図	名詞
ﾔﾝﾐﾙｽﾞﾘﾛﾝ	ヤン・ミルズ理論	名詞
ﾔｰﾝﾃﾗｰﾍﾝﾀｲ	ヤーン・テラー変態	名詞
ﾔｰﾝﾃﾗｰｺｳｶ	ヤーン・テラー効果	名詞
ﾔﾜﾗｶｲｼﾝ	軟らかいしん	名詞
ﾖｳﾊﾞｲﾜ	溶媒和	名詞
ﾖｳﾊﾞｲﾜﾃﾞﾝｼ	溶媒和電子	名詞
ﾖﾋﾞﾀﾞｼｼﾝｺﾞｳ	呼出信号	名詞
ﾖｳﾃﾞﾝｶ	陽電荷	名詞
ﾖｳﾃﾞﾝｼ	陽電子	名詞
ﾖｳﾃﾞﾝｼﾎｳｼｭﾂ	陽電子放出	名詞
ﾖｳﾃﾞﾝｼｼｮｳﾒﾂ	陽電子消滅	名詞
ﾖｳﾄﾞｳ	揺動	名詞
ﾖﾄﾞﾐﾃﾝ	よどみ点	名詞
ﾖｳﾄﾞｳﾘｮｸ	揺動力	名詞
ﾖｳﾄﾞｳｻﾝｲﾂﾃｲﾘ	揺動散逸定理	名詞
ﾖｳｴｷｾｲﾁｮｳ	溶液成長	名詞
ﾖｯﾌｪｺｳｶ	ヨッフェ効果	名詞
ﾖｯﾌｪｼﾞﾊﾞ	ヨッフェ磁場	名詞
ﾖｹﾞﾝﾎｳｿｸ	余弦法則	名詞
ﾖﾊﾝｶﾞﾀｹｯｼｮｳﾎｳ	ヨハン型結晶法	名詞
ﾖﾊﾝｾﾝｶﾞﾀｹｯｼｮｳﾎｳ	ヨハンセン型結晶法	名詞
ﾖｲﾌﾟﾛｸﾞﾗﾑ	よいプログラム	名詞
ﾖｲﾘｮｳｼｽｳ	よい量子数	名詞
ﾖｳｶｲﾄﾞ	溶解度	名詞
ﾖｳｶｲﾄﾞｾｷ	溶解度積	名詞
ﾖｳｶｲｹﾞﾝﾄﾞ	溶解限度	名詞
ﾖｳｶｲﾈﾂ	溶解熱	名詞
ﾖｳｶｲﾊﾟﾗﾒｰﾀｰ	溶解パラメーター	名詞
ﾖｳｶｲｾｲﾊﾟﾗﾒｰﾀｰ	溶解性パラメーター	名詞
ﾖｳｶｲｿｸﾄﾞ	溶解速度	名詞
ﾖｳｶｶﾄﾞﾐｳﾑｶﾞﾀﾓｹｲ	ヨウ化カドミウム型構造	名詞
ﾖｺｳ	余効	名詞
ﾖｺｴﾈﾙｷﾞｰﾎｿﾞﾝ	横エネルギー保存	名詞
ﾖｺﾍﾝｷｮｸ	横偏極	名詞
ﾖｺﾋｽﾞﾐ	横ひずみ	名詞
ﾖｺｳｶﾝｽｳ	余効関数	名詞
ﾖｺｶﾝﾜ	横緩和	名詞
ﾖｺﾓｰﾄﾞ	横モード	名詞
ﾖｺｼﾝﾄﾞｳ	横振動	名詞
ﾕｳｺｳｼﾂﾘｮｳ	有効質量	名詞
ﾖｳｺｳﾁｭｳ	陽光柱	名詞
ﾖｺｳﾝﾄﾞｳﾘｮｳ	横運動量	名詞
ﾖｺﾕﾚﾓｰﾒﾝﾄ	横ゆれモーメント	名詞
ﾖｸｹｲﾃｲｺｳ	翼形抵抗	名詞
ﾖｳｷｮｸｱﾝﾌﾞ	陽極暗部	名詞
ﾖｳｷｮｸｸﾞﾛｰ	陽極グロー	名詞
ﾖｳｷｮｸﾍﾝﾁｮｳ	陽極変調	名詞
ﾖｳｷｮｸｹﾝﾊﾟ	陽極検波	名詞
ﾖｳｷｮｸｺｳｶ	陽極降下	名詞
ﾖｳｷｮｸｾﾝ	陽極線	名詞
ﾖﾝﾌﾞﾝﾉｲﾁﾊﾁｮｳﾊﾞﾝ	四分の一波長板	名詞
ﾖﾝｹﾞﾝﾍﾞｸﾄﾙ	四元ベクトル	名詞
ﾖﾝｹﾞﾝｿｸﾄﾞ	四元速度	名詞
ﾖﾝｹﾞﾝｳﾝﾄﾞｳﾘｮｳ	四元運動量	名詞
ﾖﾝｲﾝｼｺｳｼｷ	四因子公式	名詞
ﾖﾝｺｳﾊｺﾝｺﾞｳ	四光波混合	名詞
ﾖﾝｷｮｸｶﾝ	四極管	名詞
ﾖﾝｽﾋﾟﾝ	4スピン	連体詞
4ｽﾋﾟﾝ	4スピン	連体詞
ﾖﾝﾀｲﾌｪﾙﾐｿｳｺﾞｻﾖｳ	四体フェルミ相互作用	名詞
ﾖﾝﾀﾝｼﾓｳ	四端子網	名詞
ﾖﾝﾀﾝｼｶｲﾛﾓｳ	四端子回路網	名詞
ﾖﾝﾖｳｿﾓｹｲ	四要素模型	名詞
ﾖﾙﾀﾞﾝｳｨｸﾞﾅｰﾍﾝｶﾝ	ヨルダン・ウィグナー変換	名詞
ﾖｳﾘｮｳﾌﾞﾝｾｷ	容量分析	名詞
ﾖｳﾘｮｳｹｲ	容量計	名詞
ﾖｳﾘｮｳｹｲｽｳ	容量係数	名詞
ﾖｳﾘｮｸｹｲｽｳ	揚力係数	名詞
ﾖｳﾘｮｸﾒﾝ	揚力面	名詞
ﾖｳﾘｮｸｾﾝ	揚力線	名詞
ﾖｳﾘｮｳｾｲﾘｱｸﾀﾝｽ	容量性リアクタンス	名詞
ﾖｳｾｲｹﾞﾝｿ	陽性元素	名詞
ﾖｳｾﾂｱｰｸ	溶接アーク	名詞
ﾖｳｼﾎｳｶｲ	陽子崩壊	名詞
ﾖｳｼﾎｳｼｬｶｸ	陽子放射核	名詞
ﾖｳｼｼﾝﾀﾞﾝ	陽子診断	名詞
ﾖｳｿﾊ	要素波	名詞
ﾖｽﾄｶﾝｽｳ	ヨスト関数	名詞
ﾖﾜｲｶﾚﾝﾄ	弱いカレント	名詞
ﾖﾜｲｷｮｳｼﾞｾｲ	弱い強磁性	名詞
ﾖﾜｲｿｳｺﾞｻﾖｳ	弱い相互作用	名詞
ﾖｳﾕｳｺｳﾌﾞﾝｼ	溶融高分子	名詞
ﾖｳﾕｳｾｷｴｲ	溶融石英	名詞
ﾖｼﾞｹﾞﾝｸｳｶﾝ	四次元空間	名詞
ﾖｼﾞｺｳｿﾞｳ	四次構造	名詞
ﾕｳﾃﾞﾝﾌﾞﾝｷｮｸ	誘電分極	名詞
ﾕｳﾃﾞﾝﾌﾞﾝｻﾝ	誘電分散	名詞
ﾕｳﾃﾞﾝｲｼﾞｮｳ	誘電異常	名詞
ﾕｳﾃﾞﾝｶﾈﾂ	誘電加熱	名詞
ﾕｳﾃﾞﾝｶﾝﾜ	誘電緩和	名詞
ﾕｳﾃﾞﾝﾘﾂﾀﾞｴﾝﾀｲ	誘電率楕円体	名詞
ﾕｳﾃﾞﾝﾘﾂﾀﾞｴﾝﾀｲ	誘電率だ円体	名詞
ﾕｳﾃﾞﾝｾｲ	誘電性	名詞
ﾕｳﾃﾞﾝｾｲｾﾂ	誘電正接	名詞
ﾕｳﾃﾞﾝｿﾝ	誘電損	名詞
ﾕｳﾃﾞﾝｿﾝｼﾂ	誘電損失	名詞
ﾕｳﾃﾞﾝﾃｲｽｳ	誘電定数	名詞
ﾕｳﾃﾞﾝｿﾞｳﾌｸ	誘電増幅	名詞
ﾕｳﾄﾞｳﾌﾞﾝｷｮｸ	誘導分極	名詞
ﾕｳﾄﾞｳﾃﾞﾝﾄﾞｳｷ	誘導電動機	名詞
ﾕｳﾄﾞｳﾃﾞﾝｶ	誘導電荷	名詞
ﾕｳﾄﾞｳﾃﾞﾝｷﾛ	誘導電気炉	名詞
ﾕｳﾄﾞｳﾃﾞﾝﾘｭｳ	誘導電流	名詞
ﾕｳﾄﾞｳﾊﾂﾃﾞﾝｷ	誘導発電機	名詞
ﾕｳﾄﾞｳﾎｳｼｬﾉｳ	誘導放射能	名詞
ﾕｳﾄﾞｳﾎｳｼｭﾂ	誘導放出	名詞
ﾕｳﾄﾞｳﾋｮｳｹﾞﾝ	誘導表現	名詞
ﾕｳﾄﾞｳｶﾈﾂ	誘導加熱	名詞
ﾕｳﾄﾞｳｹｲｽｳ	誘導係数	名詞
ﾕｳﾄﾞｳｹﾝﾋﾞｷｮｳ	遊動顕微鏡	名詞
ﾕｳﾄﾞｳｷﾃﾞﾝｱﾂ	誘導起電圧	名詞
ﾕｳﾄﾞｳｷﾃﾞﾝﾘｮｸ	誘導起電力	名詞
ﾕｳﾄﾞｳｺｲﾙ	誘導コイル	名詞
ﾕｳﾄﾞｳﾓｰﾀｰ	誘導モーター	名詞
ﾕｳﾄﾞｳﾘｱｸﾀﾝｽ	誘導リアクタンス	名詞
ﾕｳﾄﾞｳｻﾝﾗﾝ	誘導散乱	名詞
ﾕｳﾄﾞｳｾｲﾘｱｸﾀﾝｽ	誘導性リアクタンス	名詞
ﾕｳﾄﾞｳｼﾂﾘｮｳ	誘導質量	名詞
ﾕｳﾄﾞｳｿｳｷｮｸｼﾓｰﾒﾝﾄ	誘導双極子モーメント	名詞
ﾕｳﾄﾞｳﾀﾝｲ	誘導単位	名詞
ﾕｳﾄﾞｳﾖｳﾘｮｳ	誘導容量	名詞
ﾕｳﾄﾞｳｼﾞｶ	誘導磁化	名詞
ﾕｳﾄﾞｳｼﾞｷｲﾎｳｾｲ	誘導磁気異方性	名詞
ﾕｳｴｷｾｲﾁｮｳ	融液成長	名詞
ﾕｳｹﾞﾝｴﾈﾙｷﾞｰﾜｿｸ	有限エネルギー和則	名詞
ﾕｳｹﾞﾝｸﾞﾝ	有限群	名詞
ﾕｳｹﾞﾝｵﾝﾄﾞ	有限温度	名詞
ﾕｳｹﾞﾝｼﾝﾌﾟｸｵﾝﾊﾟ	有限振幅音波	名詞
ﾕｳｹﾞﾝﾖｳｿﾎｳ	有限要素法	名詞
ﾕｳｺﾞｳｹﾞﾝｼ	融合原子	名詞
ﾕｳｶｲｴﾝｻﾞﾝｼ	有界演算子	名詞
ﾕｳｶｲｷｮｸｾﾝ	融解曲線	名詞
ﾕｳｶｲﾈﾂ	融解熱	名詞
ﾕｳｶｲｾｷｴｲ	融解石英	名詞
ﾕｶﾜﾎﾟﾃﾝｼｬﾙ	湯川ポテンシャル	名詞
ﾕｶﾜﾘﾛﾝ	湯川理論	名詞
ﾕｶﾜｿｳｺﾞｻﾖｳ	湯川相互作用	名詞
ﾕｳｷﾊﾝﾄﾞｳﾀｲ	有機半導体	名詞
ﾕｷｶｷﾓｹｲ	雪かき模型	名詞
ﾕｷｽｷﾞﾘｮｳ	行過ぎ量	名詞
ﾕｷｽｷﾞｼﾞｶﾝ	行過ぎ時間	名詞
ﾕｳｷﾁｮｳﾃﾞﾝﾄﾞｳﾀｲ	有機超伝導体	名詞
ﾕｳｺｳﾎﾞｰｱｼﾞｼ	有効ボーア磁子	名詞
ﾕｳｺｳﾀﾞﾝﾒﾝｾｷ	有効断面積	名詞
ﾕｳｺｳﾃﾞﾝｶ	有効電荷	名詞
ﾕｳｺｳﾃﾞﾝﾘｮｸ	有効電力	名詞
ﾕｳｺｳGﾁ	有効g値	名詞
ﾕｳｺｳﾊﾐﾙﾄﾆｱﾝ	有効ハミルトニアン	名詞
ﾕｳｺｳｲｵﾝﾃﾞﾝｶ	有効イオン電荷	名詞
ﾕｳｺｳｶｲﾃﾝﾃｲｽｳ	有効回転定数	名詞
ﾕｳｺｳｶｸﾃﾞﾝｶ	有効核電荷	名詞
ﾕｳｺｳｹﾂｺﾞｳﾅｶﾞｻ	有効結合長さ	名詞
ﾕｳｺｳｷｮﾘ	有効距離	名詞
ﾕｳｺｳｵﾝﾄﾞ	有効温度	名詞
ﾕｳｺｳｵｳﾘｮｸ	有効応力	名詞
ﾕｳｺｳｼﾂﾘｮｳﾎｳﾃｲｼｷ	有効質量方程式	名詞
ﾕｳｺｳｿｳｺﾞｻﾖｳ	有効相互作用	名詞
ﾕｳｺｳｿｸﾃｲﾊﾝｲ	有効測定範囲	名詞
ﾕｳｺｳｽｳｼﾞ	有効数字	名詞
ﾕｳｺｳｼﾞﾊﾞ	有効磁場	名詞
ﾕｰｸﾘｯﾄﾞｸｳｶﾝ	ユークリッド空間	名詞
ﾕｰｸﾘｯﾄﾞﾃｷﾊﾞﾉﾘﾛﾝ	ユークリッド的場の理論	名詞
ﾕﾆﾊﾞｲﾌﾞﾚｰﾀｰ	ユニバイブレーター	名詞
ﾕﾆﾊﾞｰｻﾙﾌｱﾝﾃｲｾｲ	ユニバーサル不安定性	名詞
ﾕﾆﾎﾟｰﾗｰｼｭｳｾｷｶｲﾛ	ユニポーラー集積回路	名詞
ﾕﾆﾎﾟｰﾗｰﾄﾗﾝｼﾞｽﾀｰ	ユニポーラートランジスター	名詞
ﾕﾆﾀﾘｰﾄﾞｳﾁ	ユニタリー同値	名詞
ﾕﾆﾀﾘｰｴﾝｻﾞﾝｼ	ユニタリー演算子	名詞
ﾕﾆﾀﾘｰｸﾞﾝ	ユニタリー群	名詞
ﾕﾆﾀﾘｰﾍﾝｶﾝ	ユニタリー変換	名詞
ﾕﾆﾀﾘｰｺｳｿﾞｳｲﾝｼ	ユニタリー構造因子	名詞
ﾕﾆﾀﾘｰｾｲ	ユニタリー性	名詞
ﾕﾆﾀﾘｰｼｭｳﾀﾞﾝ	ユニタリー集団	名詞
ﾕﾆﾀﾘｰﾀｲｼｮｳｾｲ	ユニタリー対称性	名詞
ﾕﾆﾀﾘﾃｨｷｮｸｹﾞﾝ	ユニタリティ極限	名詞
ﾕｳﾘｷ	遊離基	名詞
ﾕｳﾘｼｽｳﾉﾎｳｿｸ	有理指数の法則	名詞
ﾕｳﾘﾀﾝｲｹｲ	有理単位系	名詞
ﾕﾘﾂ	輸率	名詞
ﾕﾘｳｽﾋﾞ	ユリウス日	名詞
ﾕｳｾｲｵﾝ	有声音	名詞
ﾕｳｾﾝﾊｲｺｳ	優先配向	名詞
ﾕｼﾝ	油浸	名詞
ﾕｿｳﾀﾞﾝﾒﾝｾｷ	輸送断面積	名詞
ﾕｿｳｹﾞﾝｼｮｳ	輸送現象	名詞
ﾕｿｳﾎｳﾃｲｼｷ	輸送方程式	名詞
ﾕｿｳｹｲｽｳ	輸送係数	名詞
Z0ﾎﾞｿﾝ	Z0ボソン	名詞
Z0ﾎﾞｿﾝ	$Z^0$ボソン	名詞
Z0ﾎﾞｿﾝ	Z^0ボソン	名詞
ｼﾞｭｰﾙﾈﾂ	ジュール熱	名詞
ｼﾞｭｰﾙﾉﾎｳｿｸ	ジュールの法則	名詞
ｻﾞﾋｮｳﾋｮｳｼﾞ	座標表示	名詞
ｻﾞﾋｮｳｹｲ	座標系	名詞
ｼﾞｷｶﾞｸ	磁気学	名詞
ｻﾞｸﾂ	座屈	名詞
ｻﾞﾝｷｮｳｼﾂ	残響室	名詞
ｻﾞﾝｷｮｳｼﾞｶﾝ	残響時間	名詞
ｻﾞﾝﾘｭｳﾃﾞﾝｱﾂ	残留電圧	名詞
ｻﾞﾝﾘｭｳﾃﾞﾝﾘｭｳ	残留電流	名詞
ｻﾞﾝﾘｭｳｶﾞｽﾌﾞﾝｾｷｷ	残留ガス分析器	名詞
ｻﾞﾝﾘｭｳﾋｽﾞﾐ	残留ひずみ	名詞
ｻﾞﾝﾘｭｳｲｵﾝﾃﾞﾝﾘｭｳ	残留イオン電流	名詞
ｻﾞﾝﾘｭｳｶｸ	残留核	名詞
ｻﾞﾝﾘｭｳｷﾀｲ	残留気体	名詞
ｻﾞﾝﾘｭｳｵｳﾘｮｸ	残留応力	名詞
ｻﾞﾝﾘｭｳｾﾝ	残留線	名詞
ｻﾞﾝﾘｭｳｿｳｺﾞｻﾖｳ	残留相互作用	名詞
ｻﾞﾝﾘｭｳﾃｲｺｳ	残留抵抗	名詞
ｻﾞﾝﾘｭｳﾃｲｺｳﾁ	残留抵抗値	名詞
ｻﾞﾝﾘｭｳｼﾞｶ	残留磁化	名詞
ｻﾞﾝﾘｭｳｼﾞｷ	残留磁気	名詞
ｻﾞﾝﾘｭｳｼﾞｿｸﾐﾂﾄﾞ	残留磁束密度	名詞
ｻﾞﾂｵﾝﾃﾞﾝｱﾂ	雑音電圧	名詞
ｻﾞﾂｵﾝﾊｯｾｲｷ	雑音発生器	名詞
ｻﾞﾂｵﾝｵﾝﾄﾞ	雑音温度	名詞
ｻﾞﾂｵﾝｼｽｳ	雑音指数	名詞
ｻﾞﾂｵﾝﾃｲｺｳ	雑音抵抗	名詞
ｾﾞｰﾍﾞｯｸｺｳｶ	ゼーベック効果	名詞
ｾﾞｲｶ	脆化	名詞
ｾﾞｲｾｲ	脆性	名詞
ｾﾞｲｾｲﾊｶｲ	脆性破壊	名詞
ｾﾞｰﾏﾝ	ゼーマン	人名
ｾﾞｰﾏﾝ	Zeeman	人名
ｾﾞｰﾏﾝﾌﾞﾝﾚﾂ	ゼーマン分裂	名詞
ｾﾞｰﾏﾝｴﾈﾙｷﾞｰ	ゼーマンエネルギー	名詞
ｾﾞｰﾏﾝｺｳｶ	ゼーマン効果	名詞
ｾﾞｰﾏﾝｼﾞｭﾝｲ	ゼーマン準位	名詞
ｾﾞﾝｱﾂ	全圧	名詞
ｾﾞﾝｱﾂｹｲ	全圧計	名詞
ｾﾞﾝｱﾂﾘｮｸ	全圧力	名詞
ｾﾞﾝﾋﾞﾌﾞﾝ	全微分	名詞
ｾﾞﾝﾀﾞﾝｶｿｸｷ	前段加速器	名詞
ｾﾞﾝﾀﾞﾝﾒﾝｾｷ	全断面積	名詞
ｾﾞﾝﾀﾞﾝﾆｭｳｼｬｷ	前段入射器	名詞
ｾﾞﾝﾀﾞﾝﾎﾟﾝﾌﾟ	前段ポンプ	名詞
ｾﾞﾝﾀﾞﾝｼﾝｸｳ	前段真空	名詞
ｾﾞﾝﾊﾊﾞ	全幅	名詞
ｾﾞﾝﾊﾝｼｬ	全反射	名詞
ｾﾞﾝﾍｲｺｳｶﾃｲ	前平衡過程	名詞
ｾﾞﾝﾋｽﾞﾐ	全ひずみ	名詞
ｾﾞﾝﾎｳｺｳ	全方向	連体詞
ｾﾞﾝﾌｸｺﾞｳｶｸｼﾞｮｳﾀｲ	前複合核状態	名詞
ｾﾞﾝﾌﾄﾚｰﾍﾞﾝｺｳｶ	ゼンフトレーベン効果	名詞
ｾﾞﾝｶｸｳﾝﾄﾞｳﾘｮｳ	全角運動量	名詞
ｾﾞﾝｷﾃﾞﾝﾘ	前期電離	名詞
ｾﾞﾝｷｲｵﾝｶ	前期イオン化	名詞
ｾﾞﾝｷｶｲﾘ	前期解離	名詞
ｾﾞﾝｷﾝﾊﾞ	漸近場	名詞
ｾﾞﾝｷﾝﾋｮｳｶﾎｳ	漸近評価法	名詞
ｾﾞﾝｷﾝｶｲ	漸近解	名詞
ｾﾞﾝｷﾝｷｭｳｽｳ	漸近級数	名詞
ｾﾞﾝｷﾝﾃｷｶﾝｾﾞﾝｾｲ	漸近的完全性	名詞
ｾﾞﾝｷﾝﾃｷｼﾞﾕｳｾｲ	漸近的自由性	名詞
ｾﾞﾝｷﾝﾃﾝｶｲ	漸近展開	名詞
ｾﾞﾝｷﾘｮｳｼﾛﾝ	前期量子論	名詞
ｾﾞﾝﾏｯﾀﾝｷｺｳｶ	前末端基効果	名詞
ｾﾞﾝﾊﾟｾｲﾘｭｳ	全波整流	名詞
ｾﾞﾝﾎﾟｳｻﾝﾗﾝ	前方散乱	名詞
ｾﾞﾝｼﾝｹｲｿｸｿｳﾁ	全身計測装置	名詞
ｾﾞﾝｼﾝｹｲｽｳｿｳﾁ	全身計数装置	名詞
ｾﾞﾝｼﾝｼｮｳｼｬ	全身照射	名詞
ｾﾞﾝﾁｿﾞｳﾌｸｷ	前置増幅器	名詞
ｾﾞﾛｷﾞｬｯﾌﾟﾊﾝﾄﾞｳﾀｲ	ゼロギャップ半導体	名詞
ｾﾞﾛｺｳｻﾀｲﾐﾝｸﾞ	ゼロ交差タイミング	名詞
ｾﾞﾛﾉｴﾀﾞ	ゼロの枝	名詞
ｾﾞﾛｵﾝﾊﾟ	ゼロ音波	名詞
ｾﾞﾛｾﾝｷﾞｬｯﾌﾟ	ゼロ線ギャップ	名詞
ｾﾞｰﾀﾋﾟﾝﾁ	ゼータピンチ	名詞
ｾﾞｯﾀｲｱﾂﾘｮｸｼﾝｸｳｹｲ	絶対圧力真空計	名詞
ｾﾞｯﾀｲﾋﾞﾌﾞﾝ	絶対微分	名詞
ｾﾞｯﾀｲｺﾞｻ	絶対誤差	名詞
ｾﾞｯﾀｲﾊｲｲ	絶対配位	名詞
ｾﾞｯﾀｲﾎｳ	絶対法	名詞
ｾﾞｯﾀｲｶｲﾃﾝ	絶対回転	名詞
ｾﾞｯﾀｲｹｲｽｳ	絶対計数	名詞
ｾﾞｯﾀｲｸｯｾﾂﾘﾂ	絶対屈折率	名詞
ｾﾞｯﾀｲｵﾝﾄﾞ	絶対温度	名詞
ｾﾞｯﾀｲﾚｲﾄﾞ	絶対零度	名詞
ｾﾞｯﾀｲｾｲｼｻﾞﾋｮｳｹｲ	絶対静止座標系	名詞
ｾﾞｯﾀｲｼﾂﾄﾞ	絶対湿度	名詞
ｾﾞｯﾀｲｿｸﾃｲ	絶対測定	名詞
ｾﾞｯﾀｲﾀﾝｲ	絶対単位	名詞
ｾﾞｯﾀｲﾀﾝｲｹｲ	絶対単位系	名詞
ｾﾞｯﾀｲﾄｳｷｭｳ	絶対等級	名詞
ｾﾞｯﾀｲｳﾝﾄﾞｳ	絶対運動	名詞
ｾﾞﾂｴﾝﾊｶｲ	絶縁破壊	名詞
ｾﾞﾂｴﾝﾍﾝｱﾂｷ	絶縁変圧器	名詞
ｾﾞﾂｴﾝﾃｲｺｳ	絶縁抵抗	名詞
ｾﾞﾂｴﾝﾃｲｺｳｹｲ	絶縁抵抗計	名詞
ｾﾞﾂｴﾝｿﾞｳﾌｸｷ	絶縁増幅器	名詞
ｼﾞﾊﾞﾍﾞｸﾄﾙ	磁場ベクトル	名詞
ｼﾞﾊﾞﾍﾝｺｳｶﾞﾀ	磁場偏向型	連体詞
ｼﾞﾊﾞｷｮｳﾄﾞ	磁場強度	名詞
ｼﾞﾊﾞﾉﾂﾖｻ	磁場の強さ	名詞
ｼﾞﾊﾞﾁｭｳﾚｲｷｬｸｺｳｶ	磁場中冷却効果	名詞
ｼﾞﾄﾞｳﾃﾞﾝﾘ	自動電離	名詞
ｼﾞﾄﾞｳﾃﾞﾝﾘｼﾞｮｳﾀｲ	自動電離状態	名詞
ｼﾞﾄﾞｳｶｲｾﾂｹｲ	自動回折計	名詞
ｼﾞﾄﾞｳﾘﾄｸｾｲｷﾞｮ	自動利得制御	名詞
ｼﾞﾄﾞｳｾｲｷﾞｮ	自動制御	名詞
ｼﾞﾄﾞｳｼｭｳﾊｽｳｾｲｷﾞｮ	自動周波数制御	名詞
ｼﾞｹﾞﾝﾎｳﾃｲｼｷ	次元方程式	名詞
ｼﾞｹﾞﾝｶｲｾｷ	次元解析	名詞
ｼﾞｹﾞﾝｾｲｿｸｶﾎｳ	次元正則化法	名詞
ｼﾞｸﾞｻﾞｸﾞｺｳｿﾞｳ	ジグザグ構造	名詞
ｼﾞﾊﾂﾌﾞﾝｷｮｸ	自発分極	名詞
ｼﾞﾊﾂﾃﾞﾝｷﾌﾞﾝｷｮｸ	自発電気分極	名詞
ｼﾞﾊﾂﾋｽﾞﾐ	自発ひずみ	名詞
ｼﾞﾊﾂﾎｳｼｭﾂ	自発放出	名詞
ｼﾞﾊﾂｶｸﾌﾞﾝﾚﾂ	自発核分裂	名詞
ｼﾞﾊﾂｼﾞｶ	自発磁化	名詞
ｼﾞﾍｷ	磁壁	名詞
ｼﾞﾍﾝｾｲ	磁変星	名詞
ｼﾞｲ	磁位	名詞
ｼﾞｰﾒﾝｽ	ジーメンス	名詞
ｼﾞｶ	磁荷	名詞
ｼﾞｶﾃﾞﾝﾘｭｳ	磁化電流	名詞
ｼﾞｶｲ	磁界	名詞
ｼﾞｶｲﾚﾝｽﾞ	磁界レンズ	名詞
ｼﾞｶｺﾝﾅﾝﾎｳｺｳ	磁化困難方向	名詞
ｼﾞｶｸ	磁核	名詞
ｼﾞｶｷｮｸｾﾝ	磁化曲線	名詞
ｼﾞｶﾓｰﾒﾝﾄ	磁化モーメント	名詞
ｼﾞｶﾝﾌﾞﾝｶｲﾉｳ	時間分解能	名詞
ｼﾞｶﾝﾌﾞﾝｶｲｽﾍﾟｸﾄﾙ	時間分解スペクトル	名詞
ｼﾞｶﾝﾊﾝﾃﾝ	時間反転	名詞
ｼﾞｶﾝﾊﾝﾃﾝﾌﾍﾝｾｲ	時間反転不変性	名詞
ｼﾞｶﾝﾍｲｷﾝ	時間平均	名詞
ｼﾞｶﾝｲｿﾞﾝｾｲ	時間依存性	名詞
ｼﾞｶﾝｷｮｳﾄﾞ	時間強度	名詞
ｼﾞｶﾝｵｸﾚ	時間遅れ	名詞
ｼﾞｶﾝｿｳｶﾝｶﾝｽｳ	時間相関関数	名詞
ｼﾞｶﾝﾃｷ	時間的	連体詞
ｼﾞｶﾝﾃｷｺﾋｰﾚﾝｽ	時間的コヒーレンス	名詞
ｼﾞｶﾝｼﾞｭﾝｼﾞｮｾｷ	時間順序積	名詞
ｼﾞｶﾘﾂ	磁化率	名詞
ｼﾞｶﾖｳｲﾎｳｺｳ	磁化容易方向	名詞
ｼﾞｹｲﾚﾂ	時系列	名詞
ｼﾞｷｱﾗｼ	磁気あらし	名詞
ｼﾞｷﾊﾞﾌﾞﾙ	磁気バブル	名詞
ｼﾞｷﾋﾞﾝ	磁気瓶	名詞
ｼﾞｷﾌﾞﾝｷｮｸ	磁気分極	名詞
ｼﾞｷﾀﾞｲｵｰﾄﾞ	磁気ダイオード	名詞
ｼﾞｷﾀﾞﾝｾｲﾊ	磁気弾性波	名詞
ｼﾞｷｴﾈﾙｷﾞｰ	磁気エネルギー	名詞
ｼﾞｷｴﾝﾍﾝｺｳﾆｼｮｸｾｲ	磁気円偏光二色性	名詞
ｼﾞｷｴﾝﾄﾛﾋﾟｰ	磁気エントロピー	名詞
ｼﾞｷﾊﾝｼｬ	磁気反射	名詞
ｼﾞｷﾍﾝﾀｲ	磁気変態	名詞
ｼﾞｷﾍﾝﾁｮｳ	磁気変調	名詞
ｼﾞｷﾋｽﾃﾘｼｽ	磁気ヒステリシス	名詞
ｼﾞｷﾋｽﾃﾘｼｽｷｮｸｾﾝ	磁気ヒステリシス曲線	名詞
ｼﾞｷﾋｽﾞﾐ	磁気ひずみ	名詞
ｼﾞｷﾋｽﾞﾐｺｳｶ	磁気ひずみ効果	名詞
ｼﾞｷﾋｽﾞﾐｼﾝﾄﾞｳｼ	磁気ひずみ振動子	名詞
ｼﾞｷﾎｳﾜ	磁気飽和	名詞
ｼﾞｷﾌｸｸｯｾﾂ	磁気複屈折	名詞
ｼﾞｷﾌﾘｺ	磁気振り子	名詞
ｼﾞｷｲﾄﾞ	磁気井戸	名詞
ｼﾞｷｲﾎｳｾｲ	磁気異方性	名詞
ｼﾞｷｶｲﾛ	磁気回路	名詞
ｼﾞｷｶｲﾃﾝﾌﾞﾝｻﾝ	磁気回転分散	名詞
ｼﾞｷｶｲﾃﾝﾋ	磁気回転比	名詞
ｼﾞｷｶｲﾃﾝｺｳｶ	磁気回転効果	名詞
ｼﾞｷｶｰｺｳｶ	磁気カー効果	名詞
ｼﾞｷｶﾝﾂｳ	磁気貫通	名詞
ｼﾞｷｶﾝﾜ	磁気緩和	名詞
ｼﾞｷｹｲｼﾞｮｳｲﾝｼ	磁気形状因子	名詞
ｼﾞｷｹﾝ	磁気圏	名詞
ｼﾞｷｹｯｼｮｳｿﾞｸ	磁気結晶族	名詞
ｼﾞｷｷﾛｸ	磁気記録	名詞
ｼﾞｷｺｳｶﾞｸ	磁気光学	名詞
ｼﾞｷｺｳｶﾞｸｺｳｶ	磁気光学効果	名詞
ｼﾞｷｺｳｿﾞｳ	磁気構造	名詞
ｼﾞｷｸｳｶﾝｸﾞﾝ	磁気空間群	名詞
ｼﾞｷｷｮｳ	磁気鏡	名詞
ｼﾞｷﾒﾝ	磁気面	名詞
ｼﾞｷﾓｰﾒﾝﾄ	磁気モーメント	名詞
ｼﾞｷﾓﾚﾍﾝｱﾂｷ	磁気漏れ変圧器	名詞
ｼﾞｷﾈﾝｾｲ	磁気粘性	名詞
ｼﾞｷﾈﾂﾃﾞﾝｺｳｶ	磁気熱電効果	名詞
ｼﾞｷﾈﾂｺｳｶ	磁気熱効果	名詞
ｼﾞｷﾈﾂﾘｮｳｺｳｶ	磁気熱量効果	名詞
ｼﾞｷﾆｼﾞｭｳｿｳ	磁気二重奏	名詞
ｼﾞｷｵﾝｷｮｳｺｳｶ	磁気音響効果	名詞
ｼﾞｺｵﾝﾊﾟ	磁気音波	名詞
ｼﾞｷﾎﾟﾃﾝｼｬﾙ	磁気ポテンシャル	名詞
ｼﾞｷﾌﾟﾗｽﾞﾏﾊ	磁気プラズマ波	名詞
ｼﾞｷﾚｲﾉﾙｽﾞｽｳ	磁気レイノルズ数	名詞
ｼﾞｷﾘｷｶﾞｸｲﾝｼ	磁気力学因子	名詞
ｼﾞｷﾘｮｳ	磁気量	名詞
ｼﾞｷﾘｮｳｼｽｳ	磁気量子数	名詞
ｼﾞｷﾘｭｳﾀｲﾘｷｶﾞｸ	磁気流体力学	名詞
ｼﾞｷｾｷﾄﾞｳ	磁気赤道	名詞
ｼﾞｷｾﾝｺｳ	磁気旋光	名詞
ｼﾞｷｼｺﾞｾﾝ	磁気子午線	名詞
ｼﾞｷｼﾝﾄﾞｳｷｭｳｼｭｳ	磁気振動吸収	名詞
ｼﾞｷｿｳｷｮｸﾎｳｼｬ	磁気双極放射	名詞
ｼﾞｷｿｳｷｮｸｾﾝｲ	磁気双極遷移	名詞
ｼﾞｷｿｳｷｮｸｼ	磁気双極子	名詞
ｼﾞｷｿｳｷｮｸｼｿｳｺﾞｻﾖｳ	磁気双極子相互作用	名詞
ｼﾞｷｿﾝｼﾂ	磁気損失	名詞
ｼﾞｷｼｬﾍｲ	磁気遮蔽	名詞
ｼﾞｷﾀｲｾｷｺｳｶ	磁気体積効果	名詞
ｼﾞｷﾀﾝｷｮｸｼ	磁気単極子	名詞
ｼﾞｷﾀﾝｼﾝ	磁気探針	名詞
ｼﾞｷﾃｲｺｳ	磁気抵抗	名詞
ｼﾞｷﾃｷﾌｼﾞｭﾝﾌﾞﾂ	磁気的不純物	名詞
ｼﾞｷﾃﾝﾋﾞﾝ	磁気てんびん	名詞
ｼﾞｷﾃﾝｸﾞﾝ	磁気点群	名詞
ｼﾞｷﾃﾝｲ	磁気転移	名詞
ｼﾞｷﾁﾂｼﾞｮ	磁気秩序	名詞
ｼﾞｷﾄﾙｸ	磁気トルク	名詞
ｼﾞｷﾄﾙｸｹｲ	磁気トルク計	名詞
ｼﾞｷﾄｼﾞｺﾒ	磁気閉込め	名詞
ｼﾞｷﾕｳﾄﾞｳ	磁気誘導	名詞
ｼﾞｷﾕｳﾄﾞｳｿｸ	磁気誘導束	名詞
ｼﾞｷｿﾞｳﾌｸｷ	磁気増幅器	名詞
ｼﾞｷｼﾞｮｳﾗﾝ	磁気擾乱	名詞
ｼﾞｷｼﾞｮｳﾗﾝ	磁気じょう乱	名詞
ｼﾞｯｹﾝﾌﾞﾂﾘｶﾞｸ	実験物理学	名詞
ｼﾞｯｹﾝｹｲｶｸﾎｳ	実験計画法	名詞
ｼﾞｯｹﾝｼｷ	実験式	名詞
ｼﾞｯｹﾝｼﾂｹｲ	実験室系	名詞
ｼﾞｯｺｳﾊｲｷｿｸﾄﾞ	実効排気速度	名詞
ｼﾞｯｺｳﾊﾝｹﾞﾝｷ	実効半減期	名詞
ｼﾞｯｺｳｾﾝﾘｮｳﾄｳﾘｮｳ	実効線量当量	名詞
ｼﾞｯｺｳﾁ	実効値	名詞
ｼﾞｯｺｳｿﾞｳﾊﾞｲﾘﾂ	実効増倍率	名詞
ｼﾞｯｺｳｼﾞｭﾐｮｳ	実効寿命	名詞
ｼﾞｺﾃﾞﾝﾘ	自己電離	名詞
ｼﾞｺｴﾈﾙｷﾞｰ	自己エネルギー	名詞
ｼﾞｺﾊﾝﾃﾝ	自己反転	名詞
ｼﾞｺｲﾝﾀﾞｸﾀﾝｽ	自己インダクタンス	名詞
ｼﾞｺｲｿｳﾍﾝﾁｮｳ	自己位相変調	名詞
ｼﾞｺｶｸｻﾝ	自己拡散	名詞
ｼﾞｺｶｸｻﾝｹｲｽｳ	自己拡散係数	名詞
ｼﾞｺｳｺｳｶ	時効硬化	名詞
ｼﾞｺｷｭｳｼｭｳ	自己吸収	名詞
ｼﾞｺﾑﾄﾞｳﾁｬｸﾊﾞ	自己無撞着場	名詞
ｼﾞｺﾑﾄﾞｳﾁｬｸﾊﾞ	自己無どう着場	名詞
ｼﾞｺｿｳｶﾝｶﾝｽｳ	自己相関関数	名詞
ｼﾞｺｿｸﾊﾞｸ	自己束縛	名詞
ｼﾞｺｼｭｳｿｸ	自己集束	名詞
ｼﾞｺｼｭﾂﾘｮｸ	自己出力	連体詞
ｼﾞｺｼｭﾂﾘｮｸｶﾞﾀ	自己出力型	連体詞
ｼﾞｺﾕｳﾄﾞｳ	自己誘導	名詞
ｼﾞｺﾕｳﾄﾞｳﾄｳｶ	自己誘導透過	名詞
ｼﾞｺｼﾞｿﾞｸﾎｳﾃﾞﾝ	自己持続放電	名詞
ｼﾞｺｽﾞｲﾊﾝ	自己随伴	連体詞
ｼﾞｺｽﾞｲﾊﾝｴﾝｻﾞﾝｼ	自己随伴演算子	名詞
ｼﾞｸ	磁区	名詞
ｼﾞｸｱﾜｾ	軸合せ	名詞
ｼﾞｸﾋ	軸比	名詞
ｼﾞｸﾘﾂ	軸率	名詞
ｼﾞｸﾘｭｳﾎﾟﾝﾌﾟ	軸流ポンプ	名詞
ｼﾞｸｾｲﾍﾞｸﾄﾙ	軸性ベクトル	名詞
ｼﾞｸｾｲﾍﾞｸﾄﾙｶﾚﾝﾄ	軸性ベクトルカレント	名詞
ｼﾞｸｾｲﾍﾞｸﾄﾙﾁｭｳｶﾝｼ	軸性ベクトル中間子	名詞
ｼﾞｸｳｿｳｶﾝｶﾝｽｳ	時空相関関数	名詞
ｼﾞｸｳｹ	軸受	名詞
ｼﾞｸｽﾞｹｲ	磁区図形	名詞
ｼﾞｷｮｸ	磁極	名詞
ｼﾞﾑﾌﾟﾛｯﾄ	ジムプロット	名詞
ｼﾞﾝｺｳﾎｳｼｬﾉｳ	人工放射能	名詞
ｼﾞﾝｺｳｴｲｾｲ	人工衛星	名詞
ｼﾞﾝｺｳﾎｳｼｬｾｲ	人工放射性	連体詞
ｼﾞﾝｺｳﾎｳｼｬｾｲｶｸｼｭ	人工放射性核種	名詞
ｼﾞﾝｺｳｶｸﾍﾝｶﾝ	人工核変換	名詞
ｼﾞﾝｺｳﾁｮｳｺｳｼ	人工超格子	名詞
ｼﾞﾝｾｲ	靱性	名詞
ｼﾞｵｲﾄﾞ	ジオイド	名詞
ｼﾞﾚｲｼﾝﾄﾞｳ	自励振動	名詞
ｼﾞﾘｮｸｶﾝ	磁力管	名詞
ｼﾞﾘｮｸｹｲ	磁力計	名詞
ｼﾞﾘｮｸｾﾝ	磁力線	名詞
ｼﾞﾘｮｸｾﾝﾉﾑｽﾋﾞｶｴ	磁力線の結びかえ	名詞
ｼﾞｾｲﾊｸﾏｸ	磁性薄膜	名詞
ｼﾞｾｲﾊﾝﾄﾞｳﾀｲ	磁性半導体	名詞
ｼﾞｾｲｲｵﾝ	磁性イオン	名詞
ｼﾞｾｲﾎﾟｰﾗﾛﾝ	磁性ポーラロン	名詞
ｼﾞｾｲﾘｭｳﾀｲ	磁性流体	名詞
ｼﾞｾｲﾀｲ	磁性体	名詞
ｼﾞｾｲﾁｮｳﾃﾞﾝﾄﾞｳﾀｲ	磁性超伝導体	名詞
ｼﾞｼ	磁子	名詞
ｼﾞｼﾝ	磁心	名詞
ｼﾞｼﾝ	磁針	名詞
ｼﾞｼﾝﾊ	地震波	名詞
ｼﾞｿｸ	磁束	名詞
ｼﾞｿｸﾌﾛｰ	磁束フロー	名詞
ｼﾞｿｸｶｸｻﾝｹｲｽｳ	磁束拡散係数	名詞
ｼﾞｿｸｶﾝ	磁束管	名詞
ｼﾞｿｸｹｲ	磁束計	名詞
ｼﾞｿｸｸﾘｰﾌﾟ	磁束クリープ	名詞
ｼﾞｿｸﾐﾂﾄﾞ	磁束密度	名詞
ｼﾞｿｸﾉｳｼｭｸ	磁束濃縮	名詞
ｼﾞｿｸﾘｮｳｼ	磁束量子	名詞
ｼﾞｿｸﾘｮｳｼｶ	磁束量子化	名詞
ｼﾞｿｸｾﾝ	磁束線	名詞
ｼﾞｿｸｾﾝｺｳｼ	磁束線格子	名詞
ｼﾞｿｸｾﾝｳﾝﾄﾞｳ	磁束線運動	名詞
ｼﾞｿｸﾁｮｳﾔｸ	磁束跳躍	名詞
ｼﾞｿｸｳﾝﾄﾞｳ	磁束運動	名詞
ｼﾞｿｸｼﾞｬﾝﾌﾟ	磁束ジャンプ	名詞
ｼﾞｯｼﾄｳｷｭｳ	実視等級	名詞
ｼﾞｯｿｸｷｭｳｼｭｳｹｲｽｳ	実測吸収係数	名詞
ｼﾞｽｳﾉｶｻﾅﾘ	次数の重なり	名詞
ｼﾞｽﾙﾌｨﾄﾞｹﾂｺﾞｳ	ジスルフィド結合	名詞
ｼﾞｼｮｳﾉﾁﾍｲ	事象の地平	名詞
ｼﾞﾃｲｽｳ	時定数	名詞
ｼﾞﾂｺｳｼ	実格子	名詞
ｼﾞﾂｾｲﾌﾞﾝﾎｳ	実成文法	名詞
ｼﾞﾂﾖｳﾀﾝｲ	実用単位	名詞
ｼﾞﾂﾖｳﾀﾝｲｹｲ	実用単位系	名詞
ｼﾞﾂｻﾞｲｷﾀｲ	実在気体	名詞
ｼﾞﾕｳﾊﾞ	自由場	名詞
ｼﾞﾕｳﾎﾞｳﾁｮｳ	自由膨張	名詞
ｼﾞﾕｳﾌﾞﾝｼﾈﾝｾｲｹｲｽｳ	自由分子粘性計数	名詞
ｼﾞﾕｳﾌﾞﾝｼ	自由分子	名詞
ｼﾞﾕｳﾃﾞﾝｶ	自由電荷	名詞
ｼﾞﾕｳﾃﾞﾝｼ	自由電子	名詞
ｼﾞﾕｳﾃﾞﾝｼﾓｹｲ	自由電子模型	名詞
ｼﾞﾕｳﾃﾞﾝｼﾚｰｻﾞｰ	自由電子レーザー	名詞
ｼﾞﾕｳｸﾞﾝ	自由群	名詞
ｼﾞﾕｳﾋｮｳﾒﾝ	自由表面	名詞
ｼﾞﾕｳｶｲﾃﾝｻ	自由回転鎖	名詞
ｼﾞﾕｳｺｳﾃｲ	自由行程	名詞
ｼﾞﾕｳｵﾝﾊﾞ	自由音場	名詞
ｼﾞﾕｳﾗｯｶ	自由落下	名詞
ｼﾞﾕｳｼﾝﾄﾞｳ	自由振動	名詞
ｼﾞﾕｳｽﾍﾟｸﾄﾙﾘｮｳｲｷ	自由スペクトル領域	名詞
ｼﾞﾕｳﾀｲｾｷ	自由体積	名詞
ｼﾞﾕｳﾀﾝ	自由端	名詞
ｼﾞﾕｳｳｽﾞ	自由渦	名詞
ｼﾞﾕｳｼﾞﾕｳｾﾝｲ	自由-自由遷移	名詞
ｼﾞｿﾞｸﾎｳﾃﾞﾝ	自続放電	名詞
ｼﾞｼﾞｮｳｼﾞﾊﾞｸﾃﾞﾝｼ	自縄自縛電子	名詞
ｼﾞｼﾞｮｳｼﾞﾊﾞｸﾚｲｷｼ	自縄自縛励起子	名詞
ｿﾞｳｱﾂｷ	増圧機	名詞
ｿﾞｳﾊﾞｲﾘﾂ	増倍率	名詞
ｿﾞｳﾊﾃｲｺｳ	造波抵抗	名詞
ｿﾞｳﾌｸｷ	増幅器	名詞
ｿﾞｳﾌｸﾘﾂ	増幅率	名詞
ｿﾞｳｶﾝ	増感	名詞
ｿﾞｳｶﾝｹｲｺｳ	増感蛍光	名詞
ｿﾞｳｸｳｶﾝ	像空間	名詞
ｿﾞｳﾒﾝﾜﾝｷｮｸ	像面湾曲	名詞
ｿﾞﾝﾄﾞﾊｲﾏｰｼﾝﾄﾞｳ	ゾンドハイマー振動	名詞
ｿﾞﾝﾏｰﾌｪﾙﾄ	ゾンマーフェルト	人名
ﾎｳｼｬｼﾞｮｳｹﾝ	放射条件	名詞
ｿﾞﾝﾏｰﾌｪﾙﾄﾃｲｽｳ	ゾンマーフェルト定数	名詞
ｿﾞｰﾝﾌﾟﾚｰﾄ	ゾーンプレート	名詞
ｿﾞｰﾝﾖｳﾕｳﾎｳ	ゾーン溶融法	名詞
ｿﾞｳﾘｭｳ	造粒	名詞
ｿﾞｳｼｮｸﾘﾄｸ	増殖利得	名詞
ｿﾞｳｼｮｸﾛ	増殖炉	名詞
ｽﾞｲﾊﾝｴﾝｻﾞﾝｼ	随伴演算子	名詞
ｽﾞｲﾊﾝｾｲｾｲﾊﾝﾉｳ	随伴生成反応	名詞
ｽﾞｹｲﾋｮｳｼﾞ	図形表示	名詞
ｽﾞｹｲﾋｮｳｼﾞｿｳﾁ	図形表示装置	名詞
ｽﾞﾚﾀﾞﾝｾｲｹｲｽｳ	ずれ弾性係数	名詞
ｽﾞﾚﾋｽﾞﾐ	ずれひずみ	名詞
ｽﾞﾚﾉﾅｶﾞﾚ	ずれの流れ	名詞
ｽﾞﾚｵｳﾘｮｸ	ずれ応力	名詞
ｼﾞｬﾊﾞﾗ	じゃばら	名詞
ｼﾞｬﾎﾞﾁﾝｽｷｰﾊﾝﾉｳ	ジャボチンスキー反応	名詞
ｼﾞｬｲｱﾝﾄﾊﾟﾙｽ	ジャイアントパルス	名詞
ｼﾞｬｲﾚｰﾀｰ	ジャイレーター	名詞
ｼﾞｬｲﾛｽｺｰﾌﾟ	ジャイロスコープ	名詞
ｼﾞｬｲﾛﾄﾛﾝ	ジャイロトロン	名詞
ｼﾞｬｲﾛｼﾞｷｶｲﾛｿｼ	ジャイロ磁気回路素子	名詞
ｼﾞｬｲﾛｼﾞｷｺｳｶ	ジャイロ磁気効果	名詞
ｼﾞｬｷﾉﾉﾘﾄｸ	ジャキノの利得	名詞
ｼﾞｬｸｷｮｳｼﾞｾｲ	弱強磁性	名詞
ｼﾞｬｸｼｭｳｿｸ	弱収束	名詞
ｼﾞｬｸｼｭｳｿｸｼﾝｸﾛﾄﾛﾝ	弱集束シンクロトロン	名詞
ｼﾞｬﾏｲﾀ	じゃま板	名詞
ｼﾞｬﾏﾝｶﾝｼｮｳｹｲ	ジャマン干渉計	名詞
ｼﾞｪﾘｳﾑﾓｹｲ	ジェリウム模型	名詞
ｼﾞｮｳﾃﾞﾝﾄﾞｳ	常伝導	名詞
ｼﾞｮｳﾃﾞﾝﾄﾞｳｼﾞｮｳﾀｲ	常伝導状態	名詞
ｼﾞｮｸﾞ	ジョグ	名詞
ｼﾞｮｳﾊﾂｹｲ	蒸発計	名詞
ｼﾞｮｳﾊﾂﾓｹｲ	蒸発模型	名詞
ｼﾞｮｳﾊﾂﾈﾂ	蒸発熱	名詞
ｼﾞｮｳﾎｳﾘﾛﾝ	情報理論	名詞
ｼﾞｮｳｶｲ	上界	名詞
ｼﾞｮｳｷｱｯｼｭｸｻｲｸﾙ	蒸気圧縮サイクル	名詞
ｼﾞｮｳｷｱﾂｺｳｶ	蒸気圧降下	名詞
ｼﾞｮｳｷｱﾂｵﾝﾄﾞｹｲ	蒸気圧温度計	名詞
ｼﾞｮｳｷﾌﾝｼｬﾎﾟﾝﾌﾟ	蒸気噴射ポンプ	名詞
ｼﾞｮｳｷﾈﾂﾘｮｳｹｲ	蒸気熱量計	名詞
ｼﾞｮｳｷｾﾝｼﾞｮｳ	蒸気洗浄	名詞
ｼﾞｮｳｺｳﾌｸﾃﾝ	上降伏点	名詞
ｼﾞｮｳｺｳｾﾝ	常光線	名詞
ｼﾞｮﾝｿﾝｻﾞﾂｵﾝ	ジョンソン雑音	名詞
ｼﾞｮｰﾝｽﾞ	ジョーンズ	人名
ｼﾞｮｰﾝｽﾞ	Jones	人名
ｼﾞｮｰﾝｽﾞﾍﾞｸﾄﾙ	ジョーンズベクトル	名詞
ｼﾞｮｰﾝｽﾞｷﾞｮｳﾚﾂ	ジョーンズ行列	名詞
ｼﾞｮｰﾝｽﾞｿﾞｰﾝ	ジョーンズゾーン	名詞
ｼﾞｮｳｵﾝ	上音	名詞
ｼﾞｮﾚｲ	徐冷	名詞
ｼﾞｮｳﾘｭｳﾄﾞｳﾍﾘｳﾑ	常流動ヘリウム	名詞
ｼﾞｮｳﾘｭｳﾀｲ	常流体	名詞
ｼﾞｮｾﾌｿﾝ	ジョセフソン	人名
ｼﾞｮｾﾌｿﾝ	Josephson	人名
ﾃﾞﾝｱﾂﾋｮｳｼﾞｭﾝ	電圧標準	名詞
ｼﾞｮｾﾌｿﾝﾃﾞﾝﾘｭｳ	ジョセフソン電流	名詞
ｼﾞｮｾﾌｿﾝﾄﾞｳｷｺｳｶ	ジョセフソン同期効果	名詞
ｼﾞｮｾﾌｿﾝｶｲｾﾂｺｳｶ	ジョセフソン回折効果	名詞
ｼﾞｮｾﾌｿﾝｶﾝｼｮｳｺｳｶ	ジョセフソン干渉効果	名詞
ｼﾞｮｾﾌｿﾝｺｳｶ	ジョセフソン効果	名詞
ｼﾞｮｾﾌｿﾝｹﾂｺﾞｳ	ジョセフソン結合	名詞
ｼﾞｮｾﾌｿﾝｼｭｳﾊｽｳ	ジョセフソン周波数	名詞
ｼﾞｮｾﾌｿﾝﾄﾝﾈﾙｺｳｶ	ジョセフソントンネル効果	名詞
ｼﾞｮｳｼｮｳｳﾝﾄﾞｳ	上昇運動	名詞
ｼﾞｮｳﾀｲﾍﾞｸﾄﾙ	状態ベクトル	名詞
ｼﾞｮｳﾀｲﾍﾝｽｳ	状態変数	名詞
ｼﾞｮｳﾀｲｼｷ	状態式	名詞
ｼﾞｮｳﾀｲｶﾝｽｳ	状態関数	名詞
ｼﾞｮｳﾀｲﾐﾂﾄﾞ	状態密度	名詞
ｼﾞｮｳﾀｲｾﾝﾍﾞﾂｷ	状態選別器	名詞
ｼﾞｮｳﾀｲﾜ	状態和	名詞
ｼﾞｮｳﾀｲｽﾞ	状態図	名詞
ｼﾞｮｳﾁｬｸﾏｸ	蒸着膜	名詞
ｼﾞｮｳﾖﾙｲ	剰余類	名詞
ｼﾞｮｳｻﾞｲﾎｳ	錠剤法	名詞
ｼﾞｮｳｻﾞﾝｶｲﾛ	乗算回路	名詞
ｼﾞｮｳｼﾞｾｲｶﾝﾜ	常磁性緩和	名詞
ｼﾞｮｳｼﾞｾｲｷｮｳﾒｲ	常磁性共鳴	名詞
ｼﾞｮｳｼﾞｾｲｻﾝﾗﾝ	常磁性散乱	名詞
ｼﾞｮｳｼﾞｾｲﾀｲ	常磁性体	名詞
ｼﾞｭﾄﾞｳﾌｨﾙﾀｰ	受動フィルター	名詞
ｼﾞｭﾄﾞｳｶｲﾛ	受動回路	名詞
ｼﾞｭﾄﾞｳｿｼ	受動素子	名詞
ｼﾞｭｳｹﾞﾝｼﾁｶﾝﾎｳ	重原子置換法	名詞
ｼﾞｭｳｺﾞｳ	重合	名詞
ｼﾞｭｳｺﾞｳﾄﾞ	重合度	名詞
ｼﾞｭｳｺﾞｳﾀｲ	重合体	名詞
ｼﾞｭﾊｷ	受波器	名詞
ｼﾞｭｳｲｵﾝ	重イオン	名詞
ｼﾞｭｳｲｵﾝﾊﾝﾉｳ	重イオン反応	名詞
ｼﾞｭｳｲﾁｼﾞｳﾁｭｳｾﾝ	重一次宇宙線	名詞
ｼﾞｭｰｺﾌｽｷｰﾍﾝｶﾝ	ジューコフスキー変換	名詞
ｼﾞｭｰｺﾌｽｷｰﾉｶﾃｲ	ジューコフスキーの仮定	名詞
ｼﾞｭｺｳｷ	受光器	名詞
ｼﾞｭｳﾏﾝﾀｲ	充満帯	名詞
ｼﾞｭﾝｱﾝﾃｲﾌﾞﾝｼ	準安定分子	名詞
ｼﾞｭﾝｱﾝﾃｲｹﾞﾝｼ	準安定原子	名詞
ｼﾞｭﾝｱﾝﾃｲｶｸ	準安定核	名詞
ｼﾞｭﾝｱﾝﾃｲｿｳ	準安定相	名詞
ｼﾞｭﾝｱﾝﾃｲｼﾞｮｳﾀｲ	準安定状態	名詞
ｼﾞｭﾝﾌﾞﾝｼ	準分子	名詞
ｼﾞｭﾝﾀﾞﾝｾｲｻﾝﾗﾝ	準弾性散乱	名詞
ｼﾞｭﾝﾃﾞﾝﾘｭｳ	順電流	名詞
ｼﾞｭﾝｴﾙｺﾞｰﾄﾞｶｾﾂ	準エルゴード仮説	名詞
ｼﾞｭﾝｲﾊﾊﾞ	準位幅	名詞
ｼﾞｭﾝｲｶﾝｶｸ	準位間隔	名詞
ｼﾞｭﾝｲｺｳｻﾌﾞﾝｺｳﾎｳ	準位交差分光法	名詞
ｼﾞｭﾝｲﾐﾂﾄﾞ	準位密度	名詞
ｼﾞｭﾝｲｽﾞ	準位図	名詞
ｼﾞｭﾝｶｲﾍﾞｸﾄﾙ	巡回ベクトル	名詞
ｼﾞｭﾝｶﾝｶﾃｲ	循環過程	名詞
ｼﾞｭﾝｶﾝﾘｮｳｼ	循環量子	名詞
ｼﾞｭﾝｶﾝﾃｲｽｳ	循環定数	名詞
ｼﾞｭﾝｶﾝｻﾞﾋｮｳ	循環座標	名詞
ｼﾞｭﾝｶﾂｻﾞｲ	潤滑材	名詞
ｼﾞｭﾝｹｯｼｮｳ	準結晶	名詞
ｼﾞｭﾝｵﾝ	純音	名詞
ｼﾞｭﾝﾘｭｳｼ	準粒子	名詞
ﾗﾝﾀﾞｳﾘﾛﾝ	ランダウ理論	名詞
ｼﾞｭﾝﾘｭｳｼﾉﾄﾝﾈﾙｺｳｶ	準粒子のトンネル効果	名詞
ｼﾞｭﾝｾｲ	準星	名詞
ｼﾞｭﾝｾｲﾃｷｶﾃｲ	準静的過程	名詞
ｼﾞｭﾝｽｲｼﾞｮｳﾀｲ	純粋状態	名詞
ｼﾞｭﾝﾀﾝｼｮｸｺｳ	準単色光	名詞
ｼﾞｭﾝﾃｲｼﾞｮｳﾃﾞﾝﾘｭｳ	準定常電流	名詞
ｼﾞｭﾝｳﾝﾄﾞｳﾘｮｳ	準運動量	名詞
ｼﾞｭﾝｼﾞﾛｰﾚﾝﾂﾍﾝｶﾝ	順時ローレンツ変換	名詞
ｼﾞｭｳﾛｯｷｮｸﾍﾝｹｲ	十六極変形	名詞
ｼﾞｭｰﾙ	ジュール	人名
ｼﾞｭｰﾙ	Joule	人名
ｼﾞｭｰﾙｶﾈﾂ	ジュール加熱	名詞
ｼﾞｭｰﾙｹﾙﾋﾞﾝｺｳｶ	ジュール・ケルビン効果	名詞
ｼﾞｭｰﾙｺｳｶ	ジュール効果	名詞
ｼﾞｭｰﾙﾉｼﾞｯｹﾝ	ジュールの実験	名詞
ｼﾞｭｰﾙﾄﾑｿﾝﾎﾞｳﾁｮｳ	ジュール・トムソン膨張	名詞
ｼﾞｭｰﾙﾄﾑｿﾝｹｲｽｳ	ジュール・トムソン係数	名詞
ｼﾞｭｰﾙﾄﾑｿﾝｺｳｶ	ジュール・トムソン効果	名詞
ｼﾞｭｰﾙﾄﾑｿﾝ	ジュール・トムソン	人名
ｷﾞｬｸﾃﾝｷｮｸｾﾝ	逆転曲線	名詞
ｻｲｺｳｾﾝｼﾞｯｹﾝ	細孔栓実験	名詞
ｼﾞｭｳﾘｮｳﾎﾞｳﾁｮｳｹｲ	重量膨張計	名詞
ｼﾞｭｳﾘｮｳﾌﾞﾝｾｷ	重量分析	名詞
ｼﾞｭｳﾘｮｳｷﾛｸﾞﾗﾑ	重量キログラム	名詞
ｼﾞｭｳﾘｮｸﾊﾞ	重力場	名詞
ｼﾞｭｳﾘｮｸﾊﾞﾉﾘｮｳｼﾛﾝ	重力場の量子論	名詞
ｼﾞｭｳﾘｮｸﾊ	重力波	名詞
ｼﾞｭｳﾘｮｸﾊﾝｹｲ	重力半径	名詞
ｼﾞｭｳﾘｮｸﾎｳｶｲ	重力崩壊	名詞
ｼﾞｭｳﾘｮｸｲｼﾞｮｳ	重力異常	名詞
ｼﾞｭｳﾘｮｸｶｿｸﾄﾞ	重力加速度	名詞
ｼﾞｭｳﾘｮｸﾈﾂﾘｷｶﾞｸﾃｷ	重力熱力学的	連体詞
ｼﾞｭｳﾘｮｸﾎﾟﾃﾝｼｬﾙ	重力ポテンシャル	名詞
ｼﾞｭｳﾘｮｸﾚﾝｽﾞｺｳｶ	重力レンズ効果	名詞
ｼﾞｭｳﾘｮｸﾘﾛﾝ	重力理論	名詞
ｼﾞｭｳﾘｮｸｼ	重力子	名詞
ｼﾞｭｳﾘｮｸｼﾂﾘｮｳ	重力質量	名詞
ｼﾞｭｳﾘｮｸｿｸﾃｲ	重力測定	名詞
ｼﾞｭｳﾘｮｸﾀﾝｲｹｲ	重力単位系	名詞
ｼﾞｭｳﾘｮｳｿｸﾃｲ	重力測定	名詞
ｼﾞｭｳｼﾝｹｲ	重心系	名詞
ｼﾞｭｳｼﾝｺｳｶ	重心効果	名詞
ｼﾞｭｳｼﾝｳﾝﾄﾞｳ	重心運動	名詞
ｼﾞｭｼｼﾞｮｳｹｯｼｮｳ	樹枝状結晶	名詞
ｼﾞｭｯｼﾝｹｲｽｳｶｲﾛ	十進計数回路	名詞
ｼﾞｭｳｽｲｶﾞﾀｱﾂﾘｮｸｹｲ	重錘型圧力計	名詞
ｼﾞｭｳｽｲﾛ	重水炉	名詞
ｼﾞｭｳｽｲｿ	重水素	名詞
ｼﾞｭﾜｰﾋﾞﾝ	ジュワー瓶	名詞
ｼﾞｭｳﾖｳｼ	重陽子	名詞
ｼﾞｭｳｼﾞｾﾝ	十字線	名詞
ｼﾞｭｼﾞｮｳﾄｯｷ	樹状突起	名詞
ｼﾞｭｳｼﾞｭｳｺｳ	十重項	名詞
